bobbysox	bobby socks
black jack	blackjack
bimetalism	bimetallism
boundary-rider	boundary rider
birth date	birthdate}}
bad-boy	bad boy
buwang	buang
beltloop	belt loop
bride wear	bridewear
barbarization	barbarisation
blotch on the escutcheon	blot on the escutcheon
butt load	buttload
bandelier	bandoleer
boilersuit	boiler suit
Babbitt	babbitt
black hole	blackhole
breathalysing	breathalyze
B.A.S.E. jumping	BASE jumping
balection	bolection
benzocyclohexanone	tetralone
blue-tongued lizard	blue-tongue lizard
bullet wood	bulletwood
bird's mouth	birdsmouth
bodybag	body bag
bromine hydride	hydrogen bromide
beis din	beth din
biobreak	bio-break
begorah	begorra
bogyman	bogeyman
bloomary	bloomery
bylyna	bylina
biounavailable	bio-unavailable
blog post	blogpost
bust someone's ass	bust one's ass}}
barber's pole	barber pole
breakbulk	break-bulk
build-up	buildup
boychick	boychik
bottoné	bottony
breast-girth	breastgirth
bone-meal	bone meal
bacoo	baccoo
better-off	better off
bannister	banister
ballbreaker	ball-breaker
bindrune	bind-rune
berline	berlin
boot-cut	boot cut}}
bupkes	bupkis
ball-pein hammer	ball-peen hammer
birimbao	berimbau
borfee	barfi
braunification	brunification
baptistery	baptistry
bogywoman	bogeywoman
brainfart	brain fart
bhagee	bhaji
bass-ackwards	ass-backwards
barghaist	barghest
bulti	bolty
Bloomsburian	Bloomsburyan
biolabelling	biolabeling
bromid	bromide
banddom	bandom
big head	bighead
birdtable	bird table
beach-goer	beachgoer
buck's fizz	Buck's Fizz
bowshock	bow shock
broom-rape	broomrape
ball cock	ballcock
bulletin board service	bulletin board system
boda boda	boda-boda
boogieman	bogeyman
bathochromatic	bathochromic
backannotation	back-annotation
Boodhist	Buddhist
batton	baton
babystep	baby step}}
boshintang	bosintang
broadax	broadaxe
Boodhism	Buddhism
bookkeep	book-keep
blood-wit	blood-wite
balista	ballista
B.S.	BS}}
biriyani	biryani
bandannaed	bandanaed
boybits	boy bits
bullethole	bullet hole
barline	bar line
betablocker	beta blocker
beau ideal	beau idéal
babiness	babyness
bar spin	barspin
buncombe	bunkum
blood from a turnip	blood from a stone
basse	bass
biatch	bitch
bellfrog	bell frog
Balto-Finnic	Baltic-Finnic
blow torch	blowtorch
bilimbing	bilimbi
batchelor's fare	bachelor's fare
boskage	boscage
bi-directionality	bidirectionality
beturbanned	beturbaned
blue-water	blue water
bizzy	bizzie}}
bride-price	bride price
bluescreen	blue screen
blindgrass	blind grass
bonafide	bona fide
baboushka	babushka
bunnet	bonnet
Boudiccan	Boudican
bogstandard	bog-standard
bhishti	bheestie
bullyboy	bully boy
bridgable	bridgeable
believe one's own eyes	believe one's eyes
bunn	bun
bad ass	badass
brettice	brattice
baktun	b'ak'tun
bum-fuck nowhere	bumfuck nowhere
bedizzen	bedizen
bucksome	buxom
bloodied-up	bloodied up
beglerbeg	beylerbey}}
business-as-usual	business as usual
Bar-Sinister	bar sinister
blanky	blankie
beehive of activity	hive of activity
bodyless	bodiless
brahmaness	brahminess
bally-wartch	bellywark
boomerang baby	boomerang child
bean bag	beanbag
box-spring	box spring
bon appetit	bon appétit
breathing-space	breathing space
bag men	bagmen
bifocus	bifocal
burriko	burikko
beviled	bevilled
bejabers	bejabbers
bottlenosed dolphin	bottlenose dolphin
bak choy	bok choy
breadmaker	bread maker
buttcheek	butt cheek
black comedy	black humor
beerhall	beer hall
back to back	back-to-back}}
black-currant	black currant
bear's garlic	bear garlic
boilary	boilery
book-knowledge	book knowledge}}
baby kisser	baby-kisser
ballsac	ballsack
best-off	best off
bashibazouk	bashi-bazouk
bill hook	billhook
bedehouse	beadhouse
bill-hook	billhook
Bull Mooser	Bull Moose
bardolater	bardolator
basecamp	base camp
bandonion	bandoneon
back when	way back when
biodefence	biodefense
bronchiocentric	bronchocentric
bimah	bima
bama	bamma
bootcamp	boot camp
birley	byrlaw
ba da bing ba da boom	bada bing bada boom
blab-tongue	blabtongue
boltel	boultel
bantz	bants
BBQed	barbecued}}
big brother	Big Brother
bath water	bathwater
blatino	Blatino
bidentated	bidentate
blue wall	blue wall of silence
beauty-sleep	beauty sleep
bonar	bona
blinny	blini
bee-line	beeline
bird-nest	birdnest}}
belles lettres	belles-lettres
batchelor	bachelor
by	bye
burlaw	byrlaw
beefing	biffin
by-and-by	by and by
beggar-my-neighbour	beggar-my-neighbor
bandrol	banderole
begedkefet	begadkefat
bunnyhop	bunny hop
bassackward	bass-ackwards
blowzy	blowsy
band saw	bandsaw
bisulphite	bisulfite
battle-line	battleline
bottommost	bottom-most
birefringency	birefringence
bacteraemic	bacteremic
bodypart	body part
brrr	brr
bibliograph	bibliographer
brightfield	bright field
briony	bryony
back-house	backhouse
buryingplace	burying-place
binaryness	binariness
Bisrock	bisrock
backasswards	back-asswards
button-quail	buttonquail
Bornouese	Bornuese
burrhole	burr hole
bell-tent	bell tent
bribeable	bribable
barn star	barnstar
bullrush	bulrush
bottomfeeding	bottom feeding
bleu cheese	blue cheese
bowenoid	Bowenoid
bergmehl	bergmeal
belotte	belote
bakelite	Bakelite
brown-bagger	brownbagger
bronchiogenic	bronchogenic
burqua	burka
bumper to bumper	bumper-to-bumper
blindsnake	blind snake
boconcini	bocconcini
body odor	body odour
butchers' paper	butcher paper
back country	backcountry
bed-and-breakfast	bed and breakfast
bejeezus	bejesus
BUMP	bump
brusquery	brusquerie
battlecruiser	battle-cruiser
bedeswoman	beadswoman
baidarka	bidarka
blissfull	blissful
blindspot	blind spot
bird watcher	birdwatcher
backra	buckra
bacteriovore	bacterivore
blameable	blamable
bargheist	barghest
bellhopper	bell hopper}}
balls around	balls about
base runner	baserunner
book learning	book-learning
braindump	brain dump
begink	begunk
blackbag	black-bag
blameably	blamably
bump-off	bumpoff
breakroom	break room
boastfull	boastful
bye-street	bystreet
booleanise	booleanize
butcher bird	butcherbird
bardy	bardie#Etymology 3
Belarussian	Belarusian
bdna	bDNA
buy woof tickets	sell wolf tickets
beet root	beetroot
bawly	bawley
busky	bosky
bopkes	bupkis
bioarchaeologist	bioarcheologist
biofarming	biopharming
berling	birlinn
bhaang	bhang
babooism	babuism
bunkbed	bunk bed
Bechwana	Bechuana
britches	breeches
buffalograss	buffalo grass
bo'sun	bosun
backcross	back cross
beretta	biretta
bottle-nosed dolphins	bottlenose dolphins
boardgame	board game
bang stick	bangstick
baklawah	baklava
burweed	burrweed
bead-tree	bead tree
bootlid	trunklid}}
bandobast	bundobust
boutonnière	boutonniere
back-stretches	backstretches
bathycolpian	bathykolpian
boomkin	bumkin
Bungie	Bungi
beer wort	beerwort}}
Bosniakisation	Bosniakization
boycunt	boy cunt
blow buddy	blowbuddy
ballpen	ball pen
busywork	busy work
bet a dime to a dollar	bet a dollar to a dime
brodkin	brodequin
basecourt	base court
badonkadonk	badunkadunk
book-keeping	bookkeeping
boogie-boards	boogieboards
better angels of someone's nature	better angels
breast strap	breaststrap
Baluch	Baloch
buckeroo	buckaroo
bye-law	bylaw
buku	beaucoup}}
bradykinesis	bradykinesia
burau	burao
back-and-forth	back and forth
biestings	beestings
biodad	biofather
bek	bey
bodycolour	bodycolor
break dancing	breakdancing
book worm	bookworm
blow one's own horn	toot one's own horn
battyman	batty man
bressemer	bressummer
bukovskýite	bukovskyite
brain-fever	brain fever
blow job	blowjob
bindhi	bindi
biospherean	biospherian
bodypainting	body painting
baglady	bag lady
big-fat	big fat
broken-hearted	brokenhearted
boddhisattva	bodhisattva
barytone	baritone
box of fluffies	box of fluffy ducks
Big Business	big business
boompipe	boom pipe
bromogelatine	bromogelatin
bacalao	bacalhau
brick-red	brick red
bazuco	basuco
bley	blay
brain-bucket	brain bucket
belly-wark	bellywark
basuko	basuco
beat one's swords into plowshares	beat one's swords into ploughshares
bowsy	boozy
biteshipe	bitesheep
blood-tax	blood tax
Bronsted-Lowry base	Brønsted-Lowry base
boneable	bonable
boo boo	boo-boo
battleship-gray	battleship grey
bank-and-turn indicator	turn-and-bank indicator
babool	babul
black-and-tan	black and tan
by-ways	byways
brekkers	brekker
back-reference	backreference
birdstrike	bird strike
bimoric	bimoraic
bookbin	book bin
ballocks	bollocks
byeline	byline
blimy	blimey
betwaddle	betwattle
biradari	baradari
basket weave	basketweave
boogie-board	boogieboard
by-running	byrunning
Bizantine	Byzantine
brah	bra
baklawa	baklava
brown-noser	brown noser
bitchin'	bitching
big drum	Big Drum
bacteriophaeophytin	bacteriopheophytin
bar-keeper	barkeeper
buckshish	baksheesh
b-boy	B-boy
bush-telegraph	bush telegraph
bureaucratie	bureaucracy
butyl methoxydibenzoylmethane	butylmethoxydibenzoylmethane
blonde	blond
buck-hoist	buck hoist
bandoura	bandura
bring the house down	bring down the house
booshit	bullshit
brassy	brassie
bubble up	bubble-up
brakeshoe	brake shoe
belieber	Belieber
burggravine	burgravine
back stretch	backstretch
balmorality	Balmorality
ba dum tss	ba-dum ching
babe in the wood	babe in the woods
bauf	boff
black sanctis	black sanctus
babyfaced	baby-faced
Beatle-esque	Beatlesque
Basilidian	Basilidean
blackhole	black hole
bowsing-ken	bousing ken
by-name	byname
boh liao	bo liao
buck rabbit	buck rarebit
burgeois	bourgeois
brown out	brownout
back-hander	backhander
bibimpap	bibimbap
berme	berm
biooptic	biooptical
back-handed	backhanded
boulimic	bulimic
boulimia	bulimia
bucketsort	bucket sort
bruskly	brusquely
biofemale	bio female
bicurious	bi-curious
barrel head	barrelhead
bowsing ken	bousing ken
blue-stocking	bluestocking
banker's hours	bankers' hours
bumper-sticker	bumper sticker
brineshrimp	brine shrimp
bricks-and-mortar	bricks and mortar
bas-relief	bas relief
bearhug	bear hug
balanophagous	balanephagous
bellowfish	bellowsfish
back-track	backtrack
briglow	brigalow
barnumize	Barnumize
burr oak	bur oak
bird feeder	birdfeeder
butt-hurt	butthurt}}
bare-handedly	barehandedly
buckshorn plantain	buck's horn plantain
bebeerin	bebeerine
Barney style	Barney-style
barbeque sauce	barbecue sauce}}
baetylus	baetyl
beautifullest	beautifulest
bzzzt	bzzt
biomechanic	biomechanical
babyrussa	babyroussa
book-lore	booklore
backstraight	back straight
bow-guard	bowguard
brain graph	braingraph
buzzphrase	buzz-phrase
babel	Babel
biosynthesise	biosynthesize
bovine leukemia	bovine leukaemia
backpass	back pass
best thing since sliced bread	greatest thing since sliced bread
ballflower	ball flower
betafunction	beta function
bean cake	beancake
bollen	boln
butt-load	buttload
Byelorussian	Belarusian
bellonion	belloneon
beancounter	bean counter
buttoned up	buttoned-up
bletherskate	blatherskite
bromsulfthalein	bromsulphthalein
boart	bort
bougonia	bugonia
Baroque pop	baroque pop
bald earn	bald erne
bust a cap in someone's ass	pop a cap in someone's ass
bailer	bailor
bread box	breadbox
boulle	buhl
behind-the-scenes	behind the scenes
bean feast	beanfeast
bashlik	bashlyk
borshch	borscht
Balkanise	Balkanize
barcrawl	bar crawl
boxelder	box elder
blockgroup	block group
baby's bottle	baby bottle
buy-out	buyout
broom corn	broomcorn
Bulghar	Bulgar
brush-pen	brush pen
bipolarise	bipolarize
bio-physico-chemical	biophysicochemical
bhangy	bangy
brodekin	brodequin
beam-steering	beam steering}}
bookoo	beaucoup
burghermaster	burgomaster
benshiply	beneshiply
bio break	bio-break
builders' tea	builder's tea
belly-up	belly up
bush-Kanaka	bus kanaka
bonâ fide	bona fide
big whoop	big woop
black body	blackbody
barebutt	bare-butt
bombed-out	bombed out
bishopweed	bishopsweed
boro	borough
birch wood	birchwood
brain dead	brain-dead
bull ring	bullring
borg	Borg
bolshevise	bolshevize
bruhaha	brouhaha
borb	bird
bat-shit	batshit
big-head	bighead
bottle-nose dolphin	bottlenose dolphin
bourqa	burka
butter fats	butterfats
braggle	broggle
back stairs	backstairs
bums on seats	bums in seats
Baha'i	Bahá'í
brosey	brosy
bangue	bhang
birdiesit	birdysit
big science	Big Science
ballbearing	ball bearing
beer-wort	beerwort}}
brachystochrone	brachistochrone
balotade	ballotade
break-ups	breakups
bimetalist	bimetallist
biodynamical	biodynamic
bone dry	bone-dry
boychek	boychik
borsch	borscht
benzoil	benzoyl
beldam	beldame
beslubber	beslobber
boldu	boldo
bridle-path	bridle path
bacteruria	bacteriuria
boort	bort
Bloom syndrome	Bloom's syndrome
bawtie	bawty
bull-fighting	bullfighting
borogrove	borogove
beamsplitter	beam splitter
base-on-balls	base on balls
battledoor	battledore
bati	batty
bulgar	bulgur
behind the eightball	behind the eight-ball
big momma	big mama
brushcut	brush cut
blogorrhoea	blogorrhea
Bumfuck, Nowhere	bumfuck nowhere
back wash	backwash
bitchhound	bitch hound
brain-storm	brainstorm
biomimetical	biomimetic
busy-work	busy work
brawtus	brotus
belly-button	belly button
bahooie	bahooey
bar-b-ques	barbecues
B-roll	B roll}}
bollocksology	bolloxology
basepair	base pair
blessèd	blessed
bromhidrosis	bromidrosis
bloodwit	bloodwite
barrelling	barreling
bioblast	bioplast
bejeesus	bejesus
bridge and tunnel	bridge-and-tunnel
baroscopical	baroscopic
beesting	bee sting
benthonic	benthic
buck-naked	buck naked
b-girl	B-girl
bleedthrough	bleed-through
bulldyker	bulldiker
bodihood	bodyhood
break-up	breakup
back-up	backup
blood work	bloodwork
bigger than life	larger than life
blouzalinda	blowsabella
breast girth	breastgirth
beat-boxing	beatboxing}}
basilick	basilic
bebirine	bebeerine
Banbury story of a cock and bull	Banbury story of a cock and a bull
belaboredly	belabouredly
berdash	berdache
brush off	brush-off
bet a dollar to a donut	bet a dollar to a doughnut
babooshka	babushka
banana-bender	banana bender
bareboned	bare-boned}}
brent	brant
back-of-an-envelope	back-of-the-envelope
bird brain	birdbrain
barfolicious	barfalicious
bulky refuse	bulky waste
bashfull	bashful
bacchanale	bacchanal
battleaxe	battle axe
beercan	beer can
behavioral pattern	behavioural pattern
ballbuster	ball-buster
betaglucosidase	beta-glucosidase
bitbucket	bit bucket
back-story	backstory
brick-a-brack	bric-a-brac
bulimy	bulimia
balywick	bailiwick
bitter-sweet	bittersweet
brush turkey	brush-turkey
battle-royal	battle royal
banker's draught	banker's draft
bortsch	borscht
Bungee	Bungi
bronze-wing	bronzewing
broad across the beam	broad in the beam
butt hurt	butthurt
bassinette	bassinet
breast one's cards	chest one's cards
burqa	burka
bemedalled	bemedaled
blisterpack	blister pack
buffalo-berry	buffaloberry
bitchin	bitching
burnous	burnoose
blood-stained	bloodstained
buxees	baksheesh
bull-finch	bullfinch
ballgirl	ball girl
bobeche	bobèche
bechamel sauce	béchamel sauce
bridal wear	bridalwear
barouchet	barouchette
babyfood	baby food
byke	bike
buzz-word	buzzword
blase	blasé
boombox	boom box
Boodhistic	Buddhistic
bobbysocks	bobby socks
big ass	big-ass
bounteth	bountith
butoxamine	butaxamine
bubkis	bupkis
brassnecked	brass-necked
bilgey	bilgy
burgamot	bergamot
blench holding	blanch holding
bottle-oh	bottle-o
Baseej	Basij
biscotto	biscotti
bellyflop	belly flop
bat an eyelash	bat an eyelid
boccie	bocce
babyface	baby face
by-way	byway
brava	bravo
borosulphate	borosulfate
bibliolatrist	bibliolater
bump-fire	bumpfire}}
bossy-pants	bossy pants
body-blow	body blow
Bagdadian	Baghdadian
bootilicious	bootylicious
bebinka	bebinca
bernouse	burnoose
braincell	brain cell
bus fare	busfare
bowdleriser	bowdlerizer
burgomeister	burgomaster
boosy	boose
boulting	bolting
barn burner	barnburner
bellringer	bell ringer
bonemarrow	bone marrow
binucleotide	dinucleotide
bottleshop	bottle shop
bed-ridden	bedridden
batphone	bat phone
Burkian	Burkean
bugout	bug out
briquette	briquet
Boogeyman	bogeyman
baby T	baby tee
Babbittry	babbittry
bungy rope	bungee rope
balaboosta	baleboste
bed-fast	bedfast
banker lamp	banker's lamp
boi	boy
back-water	backwater
body-slam	bodyslam
bungy jumper	bungee jumper
bell-wether	bellwether
back house	backhouse
boykie	boitjie
bembe	bemba
balonie	baloney
beer parlor	beer parlour
bloode	blood
bupivacain	bupivacaine
body-snatcher	body snatcher
broodnest	brood nest
bird shit	birdshit
banjulele	banjolele
barege	barège
betaglobin	beta globin
brantle	branle
ball and socket joint	ball-and-socket joint
bogy	bogie
bacterise	bacterize
brachymetacarpaly	brachymetacarpia
Brannock Device	Brannock device
brain storm	brainstorm
bean pole	beanpole
biomale	bio male
bilboe	bilbo
big-mouthed	bigmouthed
barkhan	barchan
billicock	billycock
bottlecap	bottle cap
beak-head	beakhead
box-calf	box calf
benzenium	benzenium ion
baby momma	baby mama
bar-b-q	barbecue
broadleaved	broad-leaved
bioenergetical	bioenergetic
backmatter	back matter
baba ghanoush	baba ganoush
braggot	bragget
beansprout	bean sprout
bretch	breach
bottle-nose dolphins	bottlenose dolphins
bird-cage	birdcage
boltcutter	bolt cutter
bloodyminded	bloody-minded
birdnest	bird's nest
bluelink	blue link
bumpstock	bump stock}}
bada boom bada bing	bada bing bada boom
beghadhkephath	begadkefat
bed frame	bedframe
bosonisation	bosonization
bourgie	bougie
bega	bigha
brow-beat	browbeat
bason	basin
bisk	bisque
burkha	burka
bi-serrate	biserrate
ballclay	ball clay
boarder cross	boardercross}}
Brody knob	Brodie knob
baracan	barracan
belletristical	belletristic
benzothiazide	benzthiazide
Big Government	big government
basterd	bastard
bathmat	bath mat
bling-bling	bling bling
bob skate	bobskate}}
bitchfight	bitch fight
buy in	buy-in
blog roll	blogroll
bluebonnet	blue bonnet
bhajia	bhaji
blow dryer	blow-dryer
bear trap	beartrap
backassward	ass-backwards
bonza	bonzer
buttie	butty
brassart	brassard
birdy	birdie
buttplug	butt plug
blasting gelatine	blasting gelatin
bike-lash	bikelash
birthname	birth name}}
bhiksuni	bhikkhuni
barrelchested	barrel-chested
back-assward	bass-ackwards
bread-stick	breadstick
bottle-opener	bottle opener
bestialise	bestialize
big wig	bigwig
blue-grey	blue-gray
belly-dumper	belly dumper
bread basket	breadbasket
basket-house	basket house
bandwaggon	bandwagon
back-handed compliment	backhanded compliment
boot-boy	boot boy
binarisation	binarization
batcha	bacha
bioinspired	bio-inspired
basorelief	bas relief
bachelor degree	bachelor's degree
bitch-whore	bitchwhore
baby-jumper	baby jumper
box-car	boxcar
blastocele	blastocoele
Behcet's disease	Behçet's disease
bolshevik	Bolshevik
brode	broddle
blue plate special	blue-plate special
broodmare	brood mare
beegum	bee gum
beatch	biatch
bird bath	birdbath
bolshy	bolshie
blackaviced	blackavised
bed-bath	bedbath
beat boxing	beatboxing}}
bellrope	bell rope
Blue Shirt	blue shirt
bearpit	bear pit
blow-jobber	blow jobber
baffie	baffy
boldhearted	bold-hearted
breastsummer	bressummer
Big Labour	big labor
broken-heartedness	brokenheartedness
Bacchic	bacchic
belligerency	belligerence
Bogomile	Bogomil
breathalysed	breathalyze
beglamorment	beglamourment
butle	buttle
bumpf	bumf
bumph	bumf
birostrated	birostrate
bag man	bagman
bill-bird	bill bird
bookstave	bookstaff
bushtucker	bush tucker
baal kore	baal korei
Blue Vinny	Blue Vinney
bizillion	bazillion
barium sulphate	barite
bootloader	boot loader
bolti	bolty
balance of probability	balance of probabilities
bhistee	bheestie
biggety	biggity
blood-thirsty	bloodthirsty
Bavarian	bavarian
brand-name	brand name
biotch	biatch
boxscore	box score
blatherskate	blatherskite
brutalize	brutalise
bachfisch	backfisch
berzerker	berserker
buggin'	bugging
biphosphatase	bisphosphatase
bellettrist	belletrist
biassing	biasing
bling	bling bling
belly-flop	belly flop
baaskap	baasskap
busheler	busheller
bacdna	bacDNA
beach-head	beachhead
buckrams	buckram
body weight	bodyweight
big ole	big old
bliny	blini
breeding ground	breeding-ground
breathalyser	breathalyzer
bloodyhandedness	bloody-handedness
bioanalyser	bioanalyzer
biobehavioural	biobehavioral
bottletop	bottle top
blood bath	bloodbath
bed-jacket	bedjacket
buta	boteh
bookteaching	book-teaching
backshish	baksheesh
brachipod	brachiopod
butt breath	buttbreath
birlie	byrlaw
bus bar	busbar
blackhouse	black-house
berzerk	berserk
blastodisc	blastodisk
big ol'	big old
britzka	britchka
bust a gasket	blow a gasket
bdellion	bdellium
butylacetate	butyl acetate
bacrna	bacRNA
butcher knife	butchers' knife
bodywrap	body wrap
boult	bolt
bodikins	bodkin
bennie	benny
BPM	bpm}}
bill of material	bill of materials
beglamor	beglamour
bawdrick	baldrick
bazil	basil
butter-muslin	butter muslin
burqaed	burkaed
Bhartriharian	Bhartrharian
bathymetrical	bathymetric
bizatch	bitch
Bobadill	Bobadil
brachymetacarpalia	brachymetacarpia
babygrow	babygro
bottle-feeder	bottlefeeder
boohoohoo	boohoo
back-handedness	backhandedness
black fly	blackfly
by-catch	bycatch
bat one's eyelashes	bat one's eyes
boltsprit	bowsprit
beat the meat	beat one's meat
bok choi	bok choy
blokieness	blokeyness
bellend	bell-end
biofuelled	biofueled
byotch	bioch
bed-check	bed check
ba'	ba
bagna càuda	bagna cauda
burst into flames	burst into flame
brandname	brand name}}
belovèd	beloved
birth rate	birthrate
back-rapper	backarapper
b'steeya	pastilla
bandstop	band-stop
bisbenzimidazole	bibenzimidazole
brickette	briquet
bio-informatics	bioinformatics
bufotenin	bufotenine
bosting	bostin
bucketshop	bucket shop
bovarism	bovarysm
blastocidin	blasticidin
beamsteering	beam steering}}
bacteriocidin	bactericidin
baby-step	baby step}}
bougainvillaea	bougainvillea
bathukolpian	bathykolpian
beauxite	bauxite
benzofurane	benzofuran
brekky	brekkie
bestselling	best-selling
backscreen	back screen
bowlegged	bow-legged
brachypteran	brachypterous
bekah	beka
bostin'	bostin
Brahminist	Brahmanist
ball-point pen	ballpoint pen
beautyness	beautiness
breakbuilding	break-building
BOGOFF	BOGOF
belye	belie
blow-off	blowoff
bogey man	bogeyman
bran-new	brand new
boil-in-the-bag	boil-in-bag
browze	browse
bloodthirsting	bloodthirsty
barb-wire	barbed wire
brimstoney	brimstony
back-end	back end
besnew	besnow
brain-pan	brainpan
bodaboda	boda-boda
blow-hard	blowhard
Bacchanal	bacchanal
bukake	bukkake
baby-talk	babytalk
barleybrakes	barleybrake
biquark	diquark}}
blow-buddy	blowbuddy
bodyline	body line
biokinematic	biokinetic
bèguèna	beguena
brick phone	bricked phone}}
bushlip	bushlips
bath room	bathroom
bathtime	bath time
backspelling	back-spelling
Baskervillian	Baskervillean
bowwow	bow-wow
bigtime	big time
blow horn	blowhorn
bunko	bunco
bronchorrhoea	bronchorrhea
Barnumise	Barnumize
brinksmanship	brinkmanship
bushpig	bush pig
bakeoff	bake-off
babariga	babanriga
backare	baccare
between times	betweentimes
buy-back	buyback
baldachino	baldacchin
browned-off	browned off
bat an eye	bat an eyelid
basturma	pastirma
bed-cover	bedcover
Bokharan	Bukharan
buy-down	buydown
bhajji	bhaji
boddhisatva	bodhisattva
base jumping	BASE jumping
ba dum tish	ba-dum ching
brussels sprout	Brussels sprout
bellhousing	bell housing
back burn	backburn
brainwashing	brain-washing
barage	barège
basinet	bascinet
book-keeper	bookkeeper
bayadeer	bayadère
berretta	biretta
bull horn	bullhorn
boy-next-door	boy next door
bot fly	botfly
block-like	blocklike
beermat	beer mat
baroflex	baroreflex
beegha	bigha
bum-fluff	bumfluff
bania	bunnia
big-sky thinking	blue-sky thinking
bayoneted	bayonetted
better angels of somebody's nature	better angels
bio energy	bioenergy
bowdlerise	bowdlerize
butcher's stripes	butcher stripes
babyccino	babycino
bullyness	bulliness}}
bounge	bung
blood lust	bloodlust
bragot	bragget
bommy	bommie
bare-skin	bareskin
blackfella	blackfellow
blow one's cool	lose one's cool
biflorate	biflorous
bed cover	bedcover
beena	beenah
banquetting	banqueting
bonacon	bonnacon
borsht	borscht
blueblood	blue blood
bulletrie	bully tree
balachaung	balachong
bass-ackward	bass-ackwards
bone idle	bone-idle
bass-bar	bass bar
barearse	bare-arse
boschveld	bushveld
blankity	blankety
blab-tale	blabtale
boothy	bothy
butcherblock	butcher block
brassey	brassie
brick-and-mortar	brick and mortar
brittlestar	brittle star
Big Lie	big lie
bromelin	bromalin
brush fire	brushfire
bird watching	birdwatching
Bungy	Bungi
Bikol	Bicol
bitrot	bit rot
bioclimatical	bioclimatic
beveling	bevelling
beit din	beth din
Breughelian	Brueghelian
byte code	bytecode
bletherer	blatherer
babydoll	baby doll
Bright Young Thing	bright young thing
benzotriazol	benzotriazole
black bag	black-bag
barb wire	barbed wire
beyt	beth
bi-directional	bidirectional
bloodbank	blood bank
bistered	bistred
bump-stock	bump stock}}
bass-violist	bass violist
BBQ'd	BBQed}}
baxterization	Baxterization
bruvva	bruvver
biaxal	biaxial
Bisquick	bisquick
brocatello	brocatel
back on to	back onto
bada boom	bada bing bada boom
breast-feed	breastfeed
back-pedal	backpedal
Blavatskyan	Blavatskian
bang-straw	bang straw
bio-available	bioavailable
be mum	be mother
butter fat	butterfat
back-hand	backhand
bankassurance	bancassurance
bermudagrass	Bermuda grass
bug-bear	bugbear
black boy	blackboy
brongniartite	brongniardite
bushhammer	bush hammer
Brown's syndrome	Brown syndrome
bycocket	bycoket
bushcricket	bush-cricket
bow tie	bowtie
blabity	blabbity
bunia	bunnia
bioregionalisation	bioregionalization
bubble gum	bubblegum
bombasine	bombazine
bupkass	bupkis
benzothiazepin	benzothiazepine
boxspring	box spring
Bubba	bubba
bothie	bothy
bhaiyya	bhaiya
blasticidine	blasticidin
bitshift	bit shift
back-fill	backfill}}
blow-out	blowout
button up one's lip	button one's lip
book-token	book token
billiken	Billiken
brush-fire	brushfire
bone-ash	bone ash
ball cap	ballcap
Bolognian stone	Bologna stone
bellwork	bell work
butt-chin	butt chin
bulimiac	bulimic
barrow man	wheel-barrow man
bump-and-grind	bump and grind
back labour	back labor
bar code	barcode
Broonite	Brownite
bolt out of the blue	bolt from the blue
byblow	by-blow
boy-shorts	boyshorts
burrhel	burhel
bully-boy	bully boy
banderol	banderole
barquette mold	barquette mould
Bolğar	Bulgar
boogerman	bogeyman
blackfellah	blackfellow
bitty	bittie
bunfight	bun fight
bloodvessel	blood vessel
bleeding-edge	bleeding edge
begadkephat	begadkefat
back-side	backside
bodycheck	body check
bargain-basement	bargain basement
behavioureme	behavioreme
bugsha	buqsha
ballboy	ball boy
basioapical	basiapical
battik	batik
Berkeleyan	Berkeleian
bio-mechanical	biomechanical
buzz-saw	buzz saw
biznatch	bitch
butylamino	tetracaine
bowling-green	bowling green
brasier	brazier
bottle feeder	bottlefeeder
boxwalla	boxwallah
blueish	bluish
banjaree	banjari
Brazil nut	brazil nut
bellyring	belly ring
besayle	besaiel
bow-tie	bowtie
buret	burette
batteau	bateau
bow-chicka-wow-wow	bow chicka wow wow
brain-cramp	brain cramp
blind man's bluff	blind man's buff
biccie	biccy
brown shirt	Brownshirt
boschbok	bushbuck
B sharp	B-sharp
back shell	backshell
bang bang chicken	bon bon chicken
bootie	bootee
buttongrass	button grass
bukshish	baksheesh
b flat	B-flat
bourbon whiskey	bourbon
bawdyhouse	bawdy-house
B. Eng.	B.Eng.
bechamel	béchamel
bollox	bollocks
biriani	biryani
bow-chicka-bow-wow	bow chicka wow wow
bargest	barghest
beat down	beatdown
blue sky	blue-sky
backpain	back pain
binome	binom
bowtel	boultel
bungkil	boengkil
bellytimber	belly-timber
bridging loan	bridge loan
bibbler	bibler
big-wig	bigwig
beat-'em-up	beat 'em up
body-part	body part
boddle	bodle
baddy	baddie
bandaid	band-aid
blackpill	black-pill
bacteriocide	bactericide
baudrick	baldrick
brown-nose	brownnose
betacarotene	beta-carotene
boogeyman	bogeyman
Bangalee	Bengali
baugh	bah
bodyspray	body spray
beanshooter	bean-shooter
bleed like a stuck hog	bleed like a stuck pig
bit plane	bitplane
blackmarket	black market}}
born again	born-again
banjo mandolin	banjo-mandolin
bronze medallist	bronze medalist
ballicatter	ballicater
beewolf	bee wolf
bread crumb	breadcrumb
bird-lime	birdlime
bossellated	bosselated
brasset	brassard
Byzantine	byzantine
blahdy blah	blah blah blah
babbitry	babbittry
bibirine	bebeerine
bunnyhug	bunny hug
blinged-out	blinged out
by guess or by golly	by guess or by gosh
bit of all right	bit of alright
blood-soaked	bloodsoaked
butt-cheek	butt cheek
balsam Canada	Canada balsam
brieve	breve}}
barley sugar	barley-sugar
bitch slap	bitch-slap
bourree	bourrée
blacklead	black lead
bocage	boscage
bigging	biggin
Buddha dharma	Buddha-dharma
bdellotomy	bdellatomy
broadmindedly	broad-mindedly
buy back	buyback
big-heartedly	bigheartedly
bare-handedness	barehandedness
big-money	big money
bucksheesh	baksheesh
battologise	battologize
boozey	boozy
boulti	bolty
banana-nose	banana nose
book shop	bookshop
besequinned	besequined
bike-shedding	bikeshedding
barber itch	barber's itch
bottom-fishing	bottom fishing
brackett	bragget
backwards compliment	backward compliment
benempt	benamed
Bethlemite	Bethlehemite
bed wetter	bedwetter
bunny-hug	bunny hug
bumboo	bumbo
brier	briar
breathing room	breathing space
baby sitting	babysitting
bicoloration	bicolouration
banishèd	banished
bonshō	bonsho
bowldery	bouldery
Bolghar	Bulgar
blowby	blow-by
birdseye	bird's-eye
blast-off	blastoff
bulldike	bulldyke
Borden	Robert Borden
bullet tree	bully tree
blouzy	blowsy
besique	bezique
baby-care	babycare
back-cross	back cross
bull-headed	bullheaded
bawan	ba-wan
blackfriar	black friar
B.J.	BJ}}
bien-pensant	bien pensant
Bungay	Bungi
badland	badlands
baulky	balky
barrathea	barathea
bungy	bungee
babacoote	babakoto
book-smart	book smart
bore-draw	bore draw
box car	boxcar
brinjarry	bunjara
bean-counter	bean counter
beef-house	beefhouse
basisphenoidal	basisphenoid
Buffalypso	buffalypso
bushwack	bushwhack
ballycater	ballicater
briss	bris
breath play	breathplay
bubkes	bupkis
bally-warche	bellywark
buckdance	buck dance
big-time	bigtime
bolletrie	bully tree
buskin'd	buskined
basrelief	bas-relief
biyotch	biatch
bowmaker	bow maker
baffed-out	baffed out
bigger fish in the sea	other fish in the sea
bedwards	bedward
blewart	blawort
bedblocker	bed blocker
benefactoress	benefactress
boat hook	boathook
barbwire	barbed wire
bovrilise	bovrilize
batterymate	battery mate
bio-female	bio female
bannerol	banderole
barbequed	barbecued
Bronsted-Lowry acid	Brønsted-Lowry acid
bokor	bocor
botanise	botanize
buie	buy
bukshee	bukshi
best-seller	bestseller
babyboomer	baby boomer
barguest	barghest
bioturbed	bioturbated
black swallowwort	black swallow-wort}}
brushoff	brush-off
birling	birlinn
basiooccipital	basioccipital
butterknives	butter knives
bayila	baila
bogmoss	bog moss
bacteriaemia	bacteraemia
berberry	barberry
barbud	barbat
boxset	box set
baal koreh	baal korei
bail-out	bailout
backtitration	back titration
bunyon	bunion
barghast	barghest
bitchy pants	bitchy-pants
bin-bag	binbag
but then again	then again
bloodyhandedly	bloody-handedly
boundarilessness	boundarylessness
butler cafe	butler café
backsheesh	baksheesh
burcak	burčák
blackey	blacky
breathalyses	breathalyze
bountifull	bountiful
brother in law	brother-in-law
battenberg	Battenberg
be here for	be there for
blasely	blasély
boat mate	boatmate
balas ruby	balas-ruby
bruck back	bruckback
break the mould	break the mold
bawdy house	bawdy-house
bastardiser	bastardizer
blameableness	blamableness
bloodynoun	bloody noun
bocci	bocce
baguet	baguette
bazouki	bouzouki
butt woman	butt-woman
backward time machine	backwards time machine
black cuckoo-shrike	black cuckooshrike
broiler house	broilerhouse
bedwet	bed-wet
break fast	breakfast
back story	backstory
Bengalee	Bengali
balot	balut
baby-walker	baby walker
billetting	billeting
bigheaded	big-headed
booya	booyah
breast-strap	breaststrap
Bahai	Bahá'í
Beit Din	beth din
bedhop	bed-hop
bed rest	bedrest
boom or bust	boom-and-bust
Brailler	brailler
bushwa	bushwah
bluejays	blue jays
braindead	brain-dead
back yard	backyard
backchannelled	backchanneled
brestsummer	bressummer
basophile	basophil
bootdisk	boot disk
behaviouralist	behavioralist
Bronsted acid	Brønsted acid
bòkò	bocor
busulphan	busulfan
bet din	beth din
bone seeker	boneseeker
Blackshirt	blackshirt
buddylist	buddy list
babykisser	baby-kisser
buxina	buxine
black aurorae	black auroras}}
bread line	breadline
blacklight	black light}}
black auroras	black aurorae}}
bazuko	basuco
bonboniere	bonbonniere
babyfy	babify
blue-chip	bluechip
bric-à-brac	bric-a-brac
birthdaycard	birthday card
bimbashi	binbashi
boyscout	boy scout
bone-hard	bone hard
Black Forest gateau	Black Forest gâteau
bupkiss	bupkis
breathalyse	breathalyze
banjara	bunjara
banjo ukelele	banjo ukulele
bezazz	pizzazz
bird-of-paradise	bird of paradise
Bancroftian	bancroftian
book-word	book word
back-stop	backstop
Bowdlerise	bowdlerize
buhrstone	burrstone
buttlover	butt lover
bi-lingual	bilingual
bumrush	bum-rush
boratto	borato
bodytights	body tights
brickcoloured	brickcolored
bacinet	bascinet
belov'd	beloved
brainstem	brain stem
boytoy	boy toy
badly-off	badly off
black-pill	black pill
back-bench	backbench
build a fire under	light a fire under
bobwig	bob wig
Boodha	Buddha
battleship gray	battleship grey
bezzant	bezant
blow one's lid	blow one's top
bath tub	bathtub
broad-leaf	broadleaf
biomimical	biomimic
biopathologic	biopathological
barish	bareish
breezeblock	breeze-block
bespirt	bespurt
bitter-cress	bittercress}}
birb	bird
beyond reasonable doubt	beyond a reasonable doubt
botoné	bottony
beddy-byes	beddy-bye
bromosulfthalein	bromsulphthalein
basilary	basilar
bastardsword	bastard sword
bun-fight	bun fight
bacronym	backronym
britzska	britchka
bluetit	blue tit
brosef	broseph
basan	basil
barracoota	barracouta
bellbottoms	bell-bottoms
bio-male	bio male
bluejay	blue jay
blockmodel	block model
bon-vivant	bon vivant
beats one's swords into plowshares	beats one's swords into ploughshares
Bashi-Bazoukery	bashi-bazoukery
blue grass	bluegrass
baboodom	babudom
boxtree	box tree
breakeven	break even
back-bite	backbite
benztropine	benzatropine
breakthru	breakthrough
bentch	bentsh
big girl pants	big-girl pants
blue-blood	blue blood
buckhorn plantain	buck's horn plantain
box-turtle	box turtle
benzoazocine	benzazocine
backseat	back seat
bromthymol	bromothymol
bumpfiring	bumpfire}}
buzz word	buzzword
beergarden	beer garden}}
balche	balché
banja	banya
battle-royale	battle royal
besant	bezant
banjh	banj
boxplot	box plot
bike shed	bikeshed
bang-tail	bangtail
base-burner	baseburner
bullbutter	bull butter
book lore	booklore
brown-out	brownout
bennied up	bennied-up
barbarise	barbarize
Bohemian	bohemian
Beothuck	Beothuk
booby-trap	booby trap
bousing-ken	bousing ken
borable	boreable
ball and socket joints	ball-and-socket joints
beleagure	beleaguer
back catalog	back catalogue
basilard	baselard
bugaboo	bug-a-boo
broad sword	broadsword
bureaucratise	bureaucratize
blimey O'Reilly	blimey O'Riley
brasen	brazen
Bourbon whiskey	bourbon whiskey
beancurd	bean curd
b-sharp	B-sharp
benzidin	benzidine
bare-headed	bareheaded
blackmoor	blackamoor
biomedicalisation	biomedicalization
bromsulphalein	bromsulphthalein
block head	blockhead
brahman	brahmin
bloedite	blödite
bicolor	bicolour
boxed standard	box standard
bon-bon	bonbon
billyo	billy-oh
barium sulfate	barium sulphate
beauty parlour	beauty parlor
balefull	baleful
burghul	bulgur
bridegoom	bridegroom
badboy	bad boy
baraesthesiometer	baresthesiometer
bifibacterium	bifidobacterium
bishounen	bishonen
billy-goat	billy goat
blackamore	blackamoor
brandlin	brandling
beigel	bagel
brain-gain	brain gain
bearcub	bear cub
big boob	big-boob
basskap	baasskap
back scratcher	backscratcher
bassbar	bass bar
bilection	bolection
burfi	barfi
Bechterew's disease	Bekhterev's disease
bloodyhanded	bloody-handed
bituminisation	bituminization
blowdry	blow-dry
boza	bosa
box bed	box-bed
biesting	beestings
Bedoon	Bidoon
blow smoke up someone's ass	blow smoke
backfire	back fire
bezoartic	bezoardic
biocatalytical	biocatalytic
breakbones	break-bones
bigger-than-life	larger than life
browseable	browsable
baritone	barytone
barcarolle	barcarole
boshbok	bushbuck
blurr	blur
betabeam	beta-beam
baptistical	baptistic
blackcurrant	black currant
Babiism	Babism
Bissel truck	Bissell truck
Brahmin	brahmin
bed-blocker	bed blocker
blokiness	blokeyness
beerbong	beer bong
bull-like	bulllike
bi-metal strip	bimetal strip
borschtsch	borscht
back-handedly	backhandedly
bank note	banknote
benzoyloxycarbonyldipeptidyl	calpeptin
breakie	brekkie
bheesty	bheestie
bhūmi	bhumi
Bosniacisation	Bosniakization
blargh	blarg
Beguard	Beghard
belly-band	bellyband
bott	bot
bahada	bajada
bean-pole	beanpole
bombazette	bombazet
belacan	belachan
bonge	bung
beach-girl	beachgirl
back-heel	backheel
bluejeans	blue jeans
black-gin	blackgin
backend	back end
bubkus	bupkis
britska	britchka
benzylidine	benzylidene
benzpyrazole	benzopyrazole
bilirubinaemia	bilirubinemia
bergmaster	barmaster
board-room	boardroom
brickmold	brickmould
beya	heya
butt ugly	butt-ugly
bump on the road	bump in the road
basidiomyceteous	basidiomycetous
Beis Din	beth din
bituminise	bituminize
brazilianisation	Brazilianization
binarised	binarized
butcher's knife	butchers' knife
butt naked	butt-naked
bell boy	bellboy
begorra	by God
breakman	brakeman
betwaddled	betwattled
bondlength	bond length
bumfluffed	bum-fluffed
bourka	burka
biramose	biramous
biyatch	biatch
bright eyed and bushy tailed	bright-eyed and bushy-tailed
Brown Shirt	brown shirt
backroad	back road
Bigfoot	bigfoot
by-your-leave	by your leave
beach head	beachhead
blackleggism	blacklegism
Bismarck	bismarck
bar hop	barhop
bosonise	bosonize
bit-depth	bit depth
bada bing	bada bing bada boom
bridon	bridoon
burkini	burqini
bousouki	bouzouki
blastomer	blastomere
barometre	barometer
bassackwards	bass-ackwards
baskethouse	basket house
blepharoadenitis	blepharadenitis
bar-be-que	barbecue
bargeboard	barge board
belly-aching	bellyaching
boozing-ken	boozing ken
backstreet	back street
basket work	basketwork
brakeline	brake line
bootcut	boot cut}}
blocklength	block length
broguing	brogueing
bleugh	bleurgh
butter-fats	butterfats
butt and ben	but and ben
brachycephalia	brachycephaly
brushturkey	brush-turkey
Batmobile	batmobile
body-building	bodybuilding
back-matter	back matter
behaviourwise	behaviorwise
bastirma	pastirma
bird song	birdsong
bell-pull	bellpull
BBQ sauce	barbecue sauce}}
Bermuda-shorts	Bermuda shorts
belabor	belabour
beguena	begena
battlefleet	battle fleet
bed-wetter	bedwetter
backs to the wall	back to the wall
buttoned-down	button-down
bicornate	bicornuate
binoxide	dioxide
brand-new	brand new
bouzouk	buzuq
blindstitch	blind stitch
bunjaree	banjari
babirussa	babiroussa
board shorts	boardshorts
butterbean	butter bean
Brazilianisation	Brazilianization
brasilein	brazilein
bear's-breech	bear's breech
blow-horn	blowhorn
buffalo berry	buffaloberry
bitchslap	bitch slap
bleck	blech
benship	beneship
basnet	bascinet
broken-heartedly	brokenheartedly
bawdkin	baldacchin
beer lore	beer-lore
buprenorphin	buprenorphine
byproduct	by-product
blastor	blaster
break-fast	breakfast
butanediamine	putrescine
buddahood	Buddahood
biocolorant	biocolourant
burnouse	burnoose
babytalk	baby talk
boramez	barometz
bizcacha	viscacha
boogyman	bogeyman
brmm	brrm
back water	backwater
boku	beaucoup}}
back biters	backbiter
beeyotch	biatch
bethroot	birthroot
britschka	britchka
bombies	bombsies
babeldom	Babeldom
bergschrund	bergshrund
board room	boardroom
bangsring	banxring
beganna	begena
bed-tea	bed tea
bethanidine	betanidine
ball club	ballclub
blind-side	blindside
bootle	boodle
bartizan	bartisan
brutalisation	brutalization
brain wave	brainwave
boarder-cross	boardercross}}
basophyl	basophil
bugong	bogong
bacteristatic	bacteriostatic
ballgame	ball game
bleedy	bloody
bise	bice
bowsaw	bow saw
Big Pharma	big pharma
belly-wahk	bellywark
black santos	black sanctus
berdiche	bardiche
beebalm	bee balm
buffetting	buffeting
bonmot	bon mot
backtranslation	back-translation
bicolored	bicoloured
baggs	bags
bottle-nosed dolphin	bottlenose dolphin
bouzing-ken	bousing ken
bánh mì	banh mi
baaskaap	baasskap
brum	brrm
bacteriemia	bacteraemia
borek	burek
bricks and mortar	brick and mortar
bastourma	pastirma
box-canyon	box canyon
bidisk	bidisc
byzantine	Byzantine
bread-basket	breadbasket
bitable	biteable
bungy jumping	bungee jumping
bat one thousand	bat a thousand
beastings	beestings
bronco-buster	broncobuster
Bruegelian	Brueghelian
bitesize	bite-size
bakability	bakeability
bathcube	bath cube
blouzabella	blowsabella
biggie	biggy
batune	baton
brokenhanded	broken-handed
B story	B-story
betroth'd	betrothed
bismuth hydride	bismuthane
Babee	Babi
battleax	battleaxe
bonusless	bonus-less
bourghul	bulgur
black humour	black humor
bee-bread	beebread
buttinski	buttinsky
bad-ass	badass
boxbed	box-bed
blow fish	blowfish
bakhshish	baksheesh
black gin	blackgin
burgraf	burgrave
bupkas	bupkis
backy	baccy
by-poll	bypoll
bakesale	bake sale
bread-and-butter pudding	bread and butter pudding
boundariless	boundaryless
back biter	backbiter
bacteræmia	bacteraemia
bussing	busing
bicarburetted	bicarbureted
bowie knife	Bowie knife
bearnaise sauce	béarnaise sauce
blindman's buff	blind man's buff
biofunctionalised	biofunctionalized
butt-breath	buttbreath
black-out	blackout
bring coals to Newcastle	carry coals to Newcastle
braceletted	braceleted
b-flat	B-flat
bloodworm	blood worm
big boned	big-boned
bullkin	bulchin
bâton	baton
basiphobia	basophobia
break-dancing	breakdancing
browridge	brow ridge
burganet	burgonet
bootscaning	bootscanning
B-cell	B cell
basskaap	baasskap
berime	berhyme
buccanier	buccaneer
brinjall	brinjal
block-head	blockhead
bromocriptin	bromocriptine
b sharp	B-sharp
Buyei	Bouyei
barydon	baryton
byrl	birle
behoove	behove
B♭	B-flat
B♯	B-sharp
bouginage	bougienage
browseability	browsability
beat the daylight out of	beat the daylights out of
bleomycine	bleomycin
barm brack	barmbrack
biach	bioch
bullet-proof	bulletproof
biland	byland
battle-ax	battle axe
batteling	battling
bivouacks	bivouacs
bullionise	bullionize
bat-phone	bat phone
big-heartedness	bigheartedness
barstool	bar stool}}
Berkeleyanism	Berkeleianism
bronchioepithelial	bronchoepithelial
blackletter	black letter
butt buddy	buttbuddy
bigotted	bigoted
biomineralise	biomineralize
behovable	behoovable
bawsin	bawson
bitter pill	bitter pill to swallow
ballottable	ballotable
boltrope	bolt rope
banian	banyan
basitarsomere	basotarsomere
backformation	back-formation
bargepole	barge pole
boom house	boomhouse
bathchair	Bath chair
ballock	bollock
billygoat	billy goat
boy shorts	boyshorts
belly band	bellyband
bandoleered	bandoliered
bit-map	bitmap
behind the 8-ball	behind the eight-ball
brasiery	braziery
bombard-phrase	bombard phrase
bare-footed	barefooted
bibliotherapeutical	bibliotherapeutic
birk	berk
barley-water	barley water
Beotian	Boeotian
back-stabby	backstabby
bikeable	bikable
bibimbop	bibimbap
bee-utiful	beautiful
barbituate	barbiturate
beasty	beastie
bioch	bitch
becos	because
bad-assery	badassery
bedhopper	bed-hopper
bugeyes	bug eyes
bonser	bonzer
brandrith	brandreth
bronchiolarization	bronchiolization
battallion	battalion
birettaed	biretta'd
big labour	big labor
bandlet	bandelet
body con	bodycon
birds' mouths	birdsmouths
barleybreaks	barleybrake
biscacha	viscacha
boot-tree	boottree
busy body	busybody
biscacho	viscacha
break off	break-off
basketstar	basket star
bournous	burnoose
bushrat	bush rat
blether	blather
black-and-white	black and white
bust someone's agates	bust someone's balls
Bichon Frise	Bichon Frisé
botaniser	botanizer
boyard	boyar
ball-club	ballclub
beachball	beach ball
bombazed	bumbazed
breadknife	bread knife
basket-work	basketwork
box cutter	boxcutter
beach girl	beachgirl
bacteriemic	bacteremic
burfee	barfi
back stretches	backstretches
bush kanaka	bus kanaka
beedie	beedi
bio-sedimentary	biosedimentary
Bodhisattwa	bodhisattva
bulghur	bulgur
briery	briary
boy-friend	boyfriend
bungy jump	bungee jump
bubblewrap	bubble wrap
birlaw	byrlaw
back-stretch	backstretch
brothel-house	brothel house}}
blowjobber	blow jobber
book-wise	bookwise
butterknife	butter knife
beread	berede
break dance	breakdance
bed-room	bedroom
brush-tailed possum	brushtail possum
bed-wetting	bedwetting
baby sitter	babysitter
bonemeal	bone meal
bloodthirstyness	bloodthirstiness
butter-fat	butterfat
boney	bony
billiphyte	biliphyte
bench warmer	bench-warmer
bowerbird	bower bird
break-wind	breakwind
Bronsted base	Brønsted base
barkentine	barquentine
bigleague	big-league
barasinga	barasingha
bioarcheological	bioarchaeological
basophilism	basophilia
bacteremia	bacteraemia
burler	birler
Baudelairian	Baudelairean
berret	beret
botkin	bodkin
barleywine	barley wine
Bedawin	bedouin
bennah	benna
bench warmers	bench-warmers
booklung	book lung
blackbox	black box
bucket-head	bucket head
batoon	baton
blackhat	black hat
Bagdadi	Baghdadi
by-law	bylaw
binman	bin man
bridemaid	bridesmaid
blasoms	blossoms
bastnäsite	bastnaesite
BEng	B.Eng.
bluenosed	blue-nosed
boche	Boche
bornous	burnoose
bilinearise	bilinearize
basso profundo	basso profondo
bejaysus	bejesus
Birminghamise	Birminghamize
bodai	bodhi
buzz cut	buzzcut
birds'-nesting	bird-nesting
bling-less	blingless
blastocoele	blastocoel
bog ore	bog iron ore
bariton	baryton
bourkha	burka
brittly	brittlely
butt in a sling	ass in a sling
burner phone	burn phone
book scorpion	book-scorpion
breast bone	breastbone
boatshed	boat shed
back-asswards	ass-backwards
beef house	beefhouse
box-office	box office
buhlwork	buhl work
bolognaise	bolognese
bushelling	busheling
bruck-back	bruckback
bugboy	bug boy
bed-frame	bedframe
bulbose	bulbous
bebeeru	bibiru
bunjy	bungee
bosquet	bosket
better angels of one's nature	better angels
B flat	B-flat
brellie	brelly
biophore	biophor
bean-cake	beancake
beeyatch	biatch
bloodymindedly	bloody-mindedly
baptisand	baptizand
blasom	blossom
bitch-hound	bitch hound
blacksploitation	blaxploitation
baftah	bafta
bare-handed	barehanded
biomom	biomother
bottlenosed dolphins	bottlenose dolphins
Badshah	Padishah
bastegh	pastegh
bar-b-que	barbecue
beat about the bush	beat around the bush
bedwench	bed wench
bleed-edge	bleed edge
bipectinated	bipectinate
biassedness	biasedness
Beatlesmania	Beatlemania
bigshot	big shot
blue-sky	blue-skies
brusk	brusque
babbit	babbitt
bump fire	bumpfire}}
bow diddley	diddley bow
buttsex	butt sex
barleybreak	barleybrake
Bunkeresque	Archie Bunkeresque
bromobenzylcyanide	bromobenzyl cyanide
body stocking	bodystocking
beller	bellow
bloody-warrior	bloody warrior
bestrought	bestraught}}
bi-partisan	bipartisan
breech delivery	breech birth
binzuke	bintsuke
back room	backroom}}
bed-sitter	bedsit
by guess or by God	by guess or by gosh
Baudelaireian	Baudelairean
back slang	backslang
burke	berk
blackie	blacky
bungy cord	bungee cord
beggar-thy-neighbour	beggar-thy-neighbor
bhaaji	bhaji
butter cream	buttercream
beaufin	biffin
bit map	bitmap
bigass	big-ass
boat-hook	boathook
bromocryptine	bromocriptine
blue-print	blueprint
borstall	borstal
benzpyrene	benzopyrene
bone head	bonehead
bugle player	bugle-player
bolt-action	bolt action
bami	bammy
bull-horn	bullhorn
blue baller	blue-baller
bragawd	bragget
blowy	blowie
boroscope	borescope
benchwarmer	bench-warmer
butanedioate	malathion
box-standard	box standard
bad-mouth	badmouth
bucolical	bucolic
boggards	boggard
breathalizer	breathalyzer
buttondown	button-down
blowdryer	blow-dryer
blintze	blintz
backdoor	back door
beluine	belluine
band-saw	bandsaw
biscuit root	biscuitroot
Bradburyan	Bradburian
bromsulfophthalein	bromsulphthalein
besaile	besaiel
baldheaded	bald-headed
bureaucratisation	bureaucratization
baubee	bawbee
bagass	bagasse
bunghole	bung-hole
buckhoist	buck hoist
bell-ringer	bell ringer
barbadeen	barbadine
bronco buster	broncobuster
biangulated	biangulate
boobie	booby
beta carotene	beta-carotene
butter face	butterface
back-burn	backburn
back-comb	backcomb
brinjaul	brinjal
blousalinda	blowsabella
booby hatch	booby-hatch
balkanise	balkanize
brownspar	brown spar
barrow-boy	barrow boy
benorylate	benorilate
boom-house	boomhouse
bizazz	pizzazz
baklavalike	baklava-like
black briony	black bryony
basilisc	basilisk
back-bone	backbone
boiar	boyar
botulinogenic	botulogenic
barbeque cottage cheese salad	barbecue cottage cheese salad
breastmilk	breast milk
behavioralism	behaviouralism
bilinearisation	bilinearization
bell end	bell-end
back-slang	backslang
benchpress	bench press
Batman	batman
babeh	baby
booktoken	book token
baisa	paisa
builtin	built in
biopsychical	biopsychic
Bloody Mary	bloody mary
ballcarrier	ball carrier
bioarcheology	bioarchaeology
beetleheaded	beetle-headed
breakeven point	break-even point
bonemouth	bone-mouth
baby faced	baby-faced
bonegraft	bone graft
bedlem	bedlam
back-bencher	backbencher
beways	beway
boggart	boggard
battleship-grey	battleship grey
bottomfeeder	bottom feeder
book store	bookstore
bow chicka bow wow	bow chicka wow wow
black water	blackwater
bitch-slap	bitch slap
barebones	bare-bones
bullbar	bull bar
bauffing	boffing
blank cheque	blank check
blackeyed	black-eyed
bassboat	bass boat
bluiter	blooter
bordeaux	Bordeaux
billy-o	billy-oh
bo's'n	bosun
beclomethasone	beclometasone
buniah	bunniah
betelnut	betel nut
blethering	blathering
brute-force	brute force
bookclub	book club
babion	baboon
bump n' grind	bump and grind
big-hearted	bighearted
bandooloo	bandulu
be onto	be on to}}
baba ganouj	baba ganoush
Boxing Week	boxing week
blecherous	bletcherous
bardee	bardie#Etymology 3
baclava	baklava
bipodal	bipedal
brideprice	bride price
bigun	biggun}}
Belorussian	Belarusian
ballbust	ball-bust
bezil	bezel
back-slapping	backslapping
best thing since sliced pan	greatest thing since sliced bread
boogie boards	boogieboards
basketcase	basket case
bottom-feeder	bottom feeder
Big Labor	big labor
backprojection	back projection
borid	boride
baby-sitter	babysitter
bathbrush	bath-brush
booshwa	bushwah
bananacue	banana cue
Bosniacization	Bosniakization
binovular	biovular
Bill Cosby sweater	Cosby sweater
baudekin	baldacchin
budmash	badmash
bat-crap	batcrap
bumpfired	bumpfire}}
bread crumbs	breadcrumbs
bailbond	bail bond
bismutite	bismuthite
back to the old drawing board	back to the drawing board}}
bakshish	baksheesh
begorrah	begorra
blastule	blastula
buck-wagon	buckwagon
back-to-basics	back to basics
bull headed	bullheaded
beserk	berserk
bionomical	bionomic
bush fire	bushfire
bodysnatcher	body snatcher
bet dollars to donuts	bet a dollar to a doughnut
blimbing	bilimbi
bubble-gum	bubblegum
bloggish	blogish
bidarkee	bidarka
by the living jingo	by jingo
bow-chica-wow-wow	bow chicka wow wow
bob-skate	bobskate}}
botija	botijo
beegah	bigha
biofertiliser	biofertilizer
barbeque	barbecue
brant goose	brent goose
backdraught	backdraft
bog standard	bog-standard
bedright	bedrite
bar fly	barfly
bruitify	brutify
Beth Din	beth din
bupkus	bupkis
back-channel	backchannel
buffaloe	buffalo
Beroean	Berean
black and white	black-and-white
bittermelon	bitter melon
boloney	baloney
beenie	beanie
broadus	brotus
bellbottom	bell-bottom
bussie	bussy
box of birds	box of fluffy ducks
bakable	bakeable
bed bug	bedbug
Burger	Burgher
bar-goer	bargoer
beardie	beardy
boulster	bolster
biomodeling	biomodelling
booterie	bootery
bikathon	bikeathon
blood-sucker	bloodsucker
bad humor	bad humour
bodice-ripper	bodice ripper
bi-dentate	bidentate
butcherknife	butchers' knife
black-heartedness	blackheartedness
blive	belive
bumble-bee	bumblebee
bee bread	beebread
Bolgar	Bulgar
biostabilisation	biostabilization
babirousa	babirusa
bellydancer	belly dancer
built in	built-in}}
bump-n'-grind	bump and grind
briarberry	brierberry
balsamical	balsamic
billy-can	billycan
bleve	belive
bedhoppers	bed-hoppers
bonedry	bone-dry
bajree	bajri
broadspectrum	broad-spectrum
baldachin	baldacchin
bbq	BBQ
butchers	butcher's
bannat	banat
bar-sinister	bar sinister
business man	businessman}}
by-form	byform
bluegum	blue gum
blackbelt	black belt
böhmite	boehmite
bombardo	bombardon
brazilianization	Brazilianization
brasilin	brazilin
bovine leucosis	bovine leukosis
buttonman	button man
bloodymindedness	bloody-mindedness
benzperidol	benperidol
blackcent	blaccent
bro hug	bro-hug
bush cricket	bush-cricket
beri-beri	beriberi
burrel	borrel
biotherapeutical	biotherapeutic
Bolingbrokian	Bolingbrokean
bull's-eye	bull's eye
bhiksu	bhikkhu
bromeligen	bromeligenous
book-lung	book lung
biooil	bio-oil
braggett	bragget
back-burner	backburner
bonspell	bonspiel
be still my beating heart	be still my heart
beauty-mark	beauty mark
belly-tember	belly-timber
bargeist	barghest
Banbury stories of a cock and bull	Banbury stories of a cock and a bull
Beluga	beluga
body slam	bodyslam
bean-feast	beanfeast
benzfetamine	benzphetamine
babelicious	babealicious
Boadicean	Boudican
back-stabbing	backstabbing
bivariated	bivariate
blomary	bloomery
bokchoi	bok choy
beau-ideal	beau idéal
bredren	bredrin
ballahou	ballahoo
big boy pants	big-boy pants
bultong	biltong
bet dollars to doughnuts	bet a dollar to a doughnut
bhajee	bhaji
battle-axe	battle axe
bloodloss	blood loss
bandanna	bandana
brussel sprout	Brussels sprout
bloodred	blood-red
barbequey	barbecuey
bitslice	bit slice
broadbean	broad bean
bow guard	bow-guard
bumbag	bum bag
bisulphide	bisulfide
baryte	barite
blacksaunt	black sanctus
break one's balls	bust one's balls
brow'd	browed
be in the pocket of someone	in someone's pocket
biosulphur	biosulfur
bi-infinite	biinfinite
blot one's copybook	blot one's copy book}}
Bowdlerize	bowdlerize
Br	Br.
binliner	bin liner
bister	bistre
backne	bacne
Baaster	Baster
bombazin	bombazine
border stone	borderstone
boardinghouse	boarding house
Bielorussian	Belarusian
belltower	bell tower
bullshite	bullshit}}
boy-cunt	boy cunt
bacteriocidal	bactericidal
bellmetal	bell metal
bi-annual	biannual
brassière	brassiere
brezilin	brazilin
birth stool	birthstool
bougainvilia	bougainvillea
blackhearted	black-hearted
box-cutter	boxcutter
bull rail	bullrail
bouzing ken	bousing ken
badtempered	bad-tempered
brogueish	broguish
bushveldt	bushveld
boy-crazy	boy crazy
bot herder	botherder
businessowner	business owner}}
bitchypants	bitchy-pants
bisulphate	bisulfate
bardacious	bodacious
bovine viral diarrhoea	bovine viral diarrhea
brmmm	brrm
bid-worthy	bidworthy
bog-house	boghouse
bye-blow	by-blow
bonewax	bone wax
bow chica wow wow	bow chicka wow wow
bogyism	bogeyism
belly-timmer	belly-timber
buckethead	bucket head
benefitter	benefiter
babywise	baby-wise
baptizable	baptisable
Brokeback	brokeback
bi-crenate	bicrenate
belar	belah
beachflea	beach flea
beigy	beigey
BBQ cottage cheese salad	barbecue cottage cheese salad
brownnoser	brown noser
balustre	baluster
biofertilisation	biofertilization
burgout	burgoo
bird-brained	birdbrained
bifocalled	bifocaled
Belarusan	Belarusian
biofunctionalisation	biofunctionalization
baulk	balk
bleaberry	blaeberry
bi-weekly	biweekly
blueblooded	blue-blooded
biocode	bio-code
bolin	bowline
blousabella	blowsabella
babble-word	babble word
bodypillow	body pillow
biomineralisation	biomineralization
bolix	bollix
barochorous	barochoric
breadbin	bread bin
broncheoalveolar	bronchoalveolar
barebum	bare-bum
bostangi	bostanji
bushshrike	bush shrike
binarise	binarize
banderillo	banderillero}}
bring around	bring round
birth chair	birthing chair
bird-dog	bird dog
bathyscaph	bathyscaphe
barberpole	barber pole
bisetous	bisetose
betalipoprotein	beta-lipoprotein
boat-hooks	boathooks
bur	burr
brainwashings	brain-washings
back-cloth	backcloth
bitchen	bitching
banoffi	banoffee
blesbok	blesbuck
Badjao	Bajau}}
blink-and-you'll-miss-it	blink-and-you-miss-it
blowsalinda	blowsabella
breast feed	breastfeed
body-con	bodycon
back formation	back-formation
bootboard	boot board
brushup	brush-up
Bingo Bango Bongo	bingo bango bongo
barrellage	barrelage
battle royale	battle royal
bandpass	band-pass
ball gown	ballgown
bum fluff	bumfluff
barrel-head	barrelhead
boulevarde	boulevard
butter my butt and call it a biscuit	butter my butt and call me a biscuit
bone-shaker	boneshaker
balabos	balebos
built up	built-up
baby-sitting	babysitting
bloody 'ell	bloody hell
bull-whip	bullwhip
bin bag	binbag
beadman	beadsman
Bobbittise	Bobbittize
brasshat	brass hat
boleen	boline
bilipschitz	bi-Lipschitz
bolline	boline
blood-suckers	bloodsuckers
bat shit	batshit
buffoonry	buffoonery
booboo	boo-boo
boyband	boy band
big-tent	big tent
basonym	basionym
boogie board	boogieboard
barbacanage	barbicanage
bang tail	bangtail
bum fuck nowhere	bumfuck nowhere
bummaloti	bummalo
broncho	bronco
barkantine	barquentine
bouillion	bouillon
Baduanjin	Ba Duan Jin
barge master	bargemaster
bolt-rope	bolt rope
balanitic	balanic
back in day	back in the day
brevotoxin	brevetoxin
