backtests	backtest
beblowing	beblow
beshares	beshare
bog-orchid	bog orchid
bleeding dry	bleed dry
barraged	barrage
bobbed wire	barbed wire
buccaniered	buccanier
blackens	blacken
beclamming	beclam
bellicous	bellicose
builds up	build up
buskles	buskle
bragged on	brag on
befouls	befoul
buskled	buskle
bolting	bolt
beggeth	beg
bringing	bring
bobbittise	Bobbittise
brushing down	brush down
beslimed	beslime
broiled	broil
butylating	butylate
beslimes	beslime
bitches off	bitch off
best-intentioned	well-intentioned
bescorns	bescorn
bears out	bear out
BED	binge eating disorder
bilging	bilge
BEP	break-even point
BEV	battery electric vehicle
bravadoing	bravado
boozes up	booze up
bonused	bonus
bittorrent	BitTorrent
bronzened	bronzen
burning plasma	burning nuclear plasma
beckoneth	beckon
bowsing	bowse
bows out	bow out
betoiling	betoil
blesseder	blessed
behested	behest
brainwashed	brainwash
bestreaking	bestreak
brainwashes	brainwash
boobytrapping	boobytrap
bobbaring	bobbar
beworking	bework
blobbing out	blob out
brandisht	brandish
besets	beset
brought	bring
begazing	begaze
brefaldin	brefeldin
beclouds	becloud
blobbier	blobby
blathers	blather
bodily-fluid	bodily fluid
blahed	blah
bolth	both
bo't	bought
binds on equip	bind on equip
befroze	befreeze
boogied down	boogie down
beats the bishop	beat the bishop
backchatted	backchat
blankened	blanken
berobbed	berob
blustering	bluster
burneth	burn
breezening	breezen
bayting	bayt
blecking	bleck
boldfaces	boldface
breese	breeze
bitterest	bitter
bassing	bass
bejuggled	bejuggle
boldfaced	boldface
blarneyed	blarney
blossomest	blossom
bcc'ed	bcc
bowling over	bowl over
broken one's lance	break one's lance
bare-metal	bare metal
barrel jumped	barrel jump
backpedaled	backpedal
breaks off	break off
backflipped	backflip
burned the candle at both ends	burn the candle at both ends
bullocked	bullock
best-behaved	well-behaved
beeping	beep
beginneth	begin
burninating	burninate
babyproofs	babyproof
blackeneth	blacken
bugling	bugle
begumming	begum
breakpointing	breakpoint
bootstrapped	bootstrap
bowlder	boulder
breastroke	breaststroke
bewielding	bewield
bulletizing	bulletize
bankrupts	bankrupt
burnt down	burn down
bucks up	buck up
body-surfing	body-surf
braises	braise
braised	braise
befalling	befall
blunges	blunge
Batmanning	Batman
bioconverted	bioconvert
blushes	blush
Burtonized	Burtonize
bangs around	bang around
Bitchzilla	bitchzilla
belaved	belave
bewept	beweep
BBQed	BBQ
Burtonizes	Burtonize
blushed	blush
borns	born
blinder	blind
bornt	born
bowle	bowl
blinded	blind
borne	bear
bitchier	bitchy
brocading	brocade
business-deal	business deal
besteth	best
bleddest	bleed
battalioning	battalion
bilked	bilk
bepelts	bepelt
bleches	blech
Burgonian	Burgundian
buffling	buffle
befleaing	beflea
backshifted	backshift
bleched	blech
betrimming	betrim
bates	bate
bepommelling	bepommel
bated	bate
breaks one off	break one off
brutalises	brutalise
besitten	besit
behaviourist	behaviorist
bedribbles	bedribble
behaviourism	behaviorism
bedribbled	bedribble
bitten	bite
bouldering	boulder
befrilling	befrill
backrolling	backroll
banged about	bang about
brusquest	brusque
betwynding	betwynde
buycotting	buycott
buffier	buffy
bushwhacking	bushwhack
begiving	begive
bethought	bethink
big phat	Nonstandard form
bacteriovory	bacterivory
boused	bouse
bemocks	bemock
belauding	belaud
benets	benet
beakiest	beaky
blocked up	block up
bouser	boozer
bouses	bouse
brings about	bring about
biffs	biff
banged to rights	bang to rights
banjaxing	banjax
blasphemes	blaspheme
boxed out	box out
blasphemed	blaspheme
balled up	ball up
beclumpsing	beclumpse
broods	brood
believest	believe
boondocked	boondock
blottiest	blotty
benighted	benight
brawns	brawn
begemming	begem
bonneting	bonnet
bemoysten	bemoisten
bielding	bield
broodingest	brooding
BIID	body integrity identity disorder
brandles	brandle
breaks the bank	break the bank
bourgeoisifying	bourgeoisify
blackmailed	blackmail
befruits	befruit
bogs down	bog down
beachballing	beachball
befringed	befringe
breaking up	break up
braying	bray
befringes	befringe
bemoistening	bemoisten
bisexualizes	bisexualize
braising	braise
bureaucratizing	bureaucratize
bamboshes	bambosh
benificial	beneficial
bisexualized	bisexualize
bamboshed	bambosh
brogued	brogue
bullshitted	bullshit
beslippered	beslipper
boysterous	boisterous
bigboob	big-boob
bological	biological
bached	bach
blottoing	blotto
bernacle	barnacle
belongeth	belong
blistered	blister
buyest	buy
blanched	blanch
barrener	barren
Britpicked	Britpick
babymooned	babymoon
backchecked	backcheck
boarded	board
blanches	blanch
blew	blue
bleezed	bleeze
beclogged	beclog
bleezes	bleeze
bepesters	bepester
blem	blemished
brings back	bring back
best	well
benewing	benew
befound	befind
balancest	balance
bookmarking	bookmark
bemauls	bemaul
backprinted	backprint
braggin'	bragging
benchmarked	benchmark
baldens	balden
bongoing	bongo
benignest	benign
bogging off	bog off
beclogging	beclog
Blessed	blessed
bugbearing	bugbear
badding	bad
BCL	w:Bachelor of Civil Law
bisoness	business
BCE	before Common Era or Christian Era
BCF	bromochlorodifluoromethane
BCG	blue compact galaxy
blonds	blond
bedaggling	bedaggle
BPB	BIOS parameter block
blenks	blenk
BCT	brigade combat team
boxier	boxy
billing	bill
BPF	w:band-pass filter
bothers	bother
biostimulates	biostimulate
biohydrogenated	biohydrogenate
bruising up	bruise up
besmutted	besmut
bespouting	bespout
benights	benight
bunniest	bunny
buccopharayngeal	buccopharyngeal
bemists	bemist
black santis	black sanctus
baulked	baulk
bad-mouths	bad-mouth
bronziest	bronzy
bloudless	bloodless
blindening	blinden
backflushing	backflush
bakers dozen	baker's dozen
bluewashing	bluewash
backhauling	backhaul
biting the bullet	bite the bullet
brought out	bring out
babied	baby
breaks even	break even
bespeeching	bespeech
barges in	barge in
babies	baby
brines	brine
boinged	boing
boiled	boil
behappening	behappen
biotests	biotest
blowing the whistle	blow the whistle
bidness	business
blackwashed	blackwash
brobs	brob
bewhispering	bewhisper
blackwashes	blackwash
befaling	befal
backhanded	backhand
built upon	build upon
back-bit	back-bite
belammed	belam
bemuddled	bemuddle
bepestered	bepester
bradded	brad
bubbled up	bubble up
begrasped	begrasp
B.C.E.	bachelor of civil engineering
beloves	belove
blegging	bleg
butchering	butcher
broken with	break with
breakdances	breakdance
beloved	belove
begyle	beguile
bleu-cheese	bleu cheese
barnacled	barnacle
ballasted	ballast
Barnumizing	Barnumize
backprints	backprint
barnacles	barnacle
birth	berth
bivouacing	bivouac
bimorphic	biomorphic
boundeth	bound
breathalyzing	breathalyze
bn.	billion
biologizing	biologize
braunschweiger	Braunschweiger
breaking off	break off
ballooned	balloon
bespeeded	bespeed
boasteth	boast
bolshevism	Bolshevism
brethren in arms	brother in arms
been able to	be able to
blackmarking	blackmark
brazened	brazen
backreads	backread
betimed	betime
blackleads	blacklead
boldening	bolden
beflowered	beflower
bumfucks	bumfuck
bemoisten'd	bemoisten
backtalking	backtalk
bottomed the house	bottom the house
begottest	beget
broadcast-station	broadcast station
beblooded	beblood
begunks	begunk
binded	bind
balmier	balmy
Bd.	board
bagged up	bag up
burner	Burner
brailed	brail
borken	bork
beshadowing	beshadow
borked	bork
balking	balk
boycotts	boycott
benches	bench
broke one's lance	break one's lance
benched	bench
begummed	begum
behavedst	behave
boxed in	box in
breakpointed	breakpoint
barred	bar
beinge	be
bretticing	brettice
biographying	biography
Brexited	Brexit
bruted	brute
bownd	bound
bespousing	bespouse
blankest	blank
BOFH	bastard operator from hell
Britishest	British
better-looking	good-looking
barketh	bark
bracest	brace
b.	born
brachiated	brachiate
boxcarred	boxcar
buffing the muffin	buff the muffin
blows one's load	blow one's load
boilerplated	boilerplate
bevelling	bevel
backhauled	backhaul
brachiates	brachiate
banquetted	banquet
brattling	brattle
blockading	blockade
ball-busting	ball-bust
braunche	branch
bummiest	bummy
basified	basify
blastodics	blastodisc
burgeonest	burgeon
blicking	blick
boom-booms	boom-boom
befanging	befang
betwyndes	betwynde
bespitting	bespit
bebothers	bebother
builds down	build down
begirds	begird
brings	bring
bashing the bishop	bash the bishop
besprenges	besprenge
becuase	because
buprenorfine	buprenorphine
ballsing on	balls on
blackified	blackify
balloonneers	ballooners
batmans	batman
blackifies	blackify
bespouted	bespout
befetters	befetter
buckdances	buckdance
backwinging	backwing
beamed	beam
burning down	burn down
buckdanced	buckdance
backs away	back away
burdeneth	burden
bfast	breakfast
by-peeping	by-peep
betoils	betoil
bunging up	bung up
bill of laden	bill of lading
bribes	bribe
buccaning	buccan
barbarises	barbarise
bicycles	bicycle
bringing out	bring out
bringe	bring
barbarised	barbarise
back-biting	back-bite
bench pressed	bench press
blurriest	blurry
bluffer	bluff
blows a fuse	blow a fuse
bilges	bilge
bleeve	believe
balistocardiogram	ballistocardiogram
bluffed	bluff
bichromatizing	bichromatize
bilged	bilge
belks	belk
bynaming	byname
bulldozes	bulldoze
befurring	befur
bulldozed	bulldoze
bastardisation	bastardization
build up	buildup
bewaring	beware
Bor.	borough
boulting	boult
bruises up	bruise up
Baidued	Baidu
brandwashes	brandwash
bustleth	bustle
blunted	blunt
bleeding white	bleed white
brandwashed	brandwash
blighteth	blight
brachygnatism	brachygnathism
boofier	boofy
bockland	bookland
bunkered	bunker
bamfoozling	bamfoozle
betwaddled	betwaddle
betther	better
blackbags	blackbag
banqueted	banquet
bizarrer	bizarre
bedaubing	bedaub
betwaddles	betwaddle
bulkened	bulken
BLOB	binary large object
bepelted	bepelt
brickfilmed	brickfilm
boyles	boyle
bloods	blood
bellowsing	bellows
barnstormed	barnstorm
boyled	boyle
betraying	betray
baroinhibited	baroinhibit
butchiest	butchy
bended	bend
backburning	backburn
bumps off	bump off
broken down	break down
bemiring	bemire
Busanian	Busan
bouned	boun
balkanizing	balkanize
brought up short	bring up short
biomagnified	biomagnify
bepatting	bepat
begodded	begod
bagpacking	backpacking
biomagnifies	biomagnify
bouffing	bouffe
bleedier	bleedy
batteneth	batten
believes	believe
barning	barn
bapping	bap
believed	believe
BAT	best available technology
BAS	Bachelor of Applied Science
belling the cat	bell the cat
blastin'	blasting
bulkiest	bulk
bitch-slapped	bitch-slap
BAC	bureau
betray'd	betray
BAN	British Approved Name
BAO	baryon acoustic oscillation
BAL	broad absorption line trough
bendest	bend
buttered	butter
beblasted	beblast
beshining	beshine
black-sant	black sanctus
binds over	bind over
backpeddling	backpeddle
behowls	behowl
bogs off	bog off
blobs out	blob out
bosonised	bosonise
bit bucketed	bit bucket
baclophen	baclofen
brings home	bring home
befleeing	beflee
broken in	break in
bosonises	bosonise
benzoase	benzonase
brothier	brothy
backfilled	backfill
boldly going where no man has gone before	boldly go where no man has gone before
billingsgating	billingsgate
blustered	bluster
batoned	baton
bucking	buck
britted	brit
babbing	bab
bossed about	boss about
bishopping	bishop
banjoed	banjo
bestirring	bestir
BRBNS	blue rubber bleb nevus syndrome
bossing around	boss around
bobsleighed	bobsleigh
buckin'	bucking
bedares	bedare
breezing	breeze
backflipping	backflip
barkening	barken
BASc	Bachelor of Applied Science
bedded out	bed out
bowling	bowl
blacktops	blacktop
buffetting	buffet
bursting	burst
brisking	brisk
boosie	boosies
boning up	bone up
blowzier	blowzy
bouyant	buoyant
brags	brag
blu	blue
beatedst	beat
belecturing	belecture
bronzifying	bronzify
bln	billion
bore in with	bear in with
blk	black
bordering	border
bouning	boun
burstin'	bursting
Braille	braille
brought to justice	bring to justice
bumps	bump
blurted out	blurt out
bay-beh	baby
bulleted	bullet
bassa	bashaw
benching	bench
braaied	braai
blissening	blissen
bougier	bougie
backbending	backbend
blanke	blank
bar mitzvahs	bar mitzvah
boddice	bodice
balthazar	Balthazar
betrusts	betrust
boking	boke
buckrams	buckram
beaute	beauty
beautifool	beautiful
barnacling	barnacle
bedaubed	bedaub
baaing	baa
bunded	bund
begotten	beget
bendier	bendy
bedrabbles	bedrabble
bracketed	bracket
Britifies	Britify
Balt.	Baltimore
besprent	besprenge
bugbeared	bugbear
bars out	bar out
bruised up	bruise up
bulwarking	bulwark
baksheeshed	baksheesh
backstabs	backstab
buries	bury
buying wolf tickets	buy wolf tickets
Britishized	Britishize
bourgeoning	bourgeon
bioinvaded	bioinvade
bootblacking	bootblack
buried	bury
Britified	Britify
Britishizes	Britishize
betops	betop
biotinylates	biotinylate
befettered	befetter
BOTD	benefit of the doubt
boots out	boot out
beglooms	begloom
becudgeling	becudgel
blinding	blind
blubbers	blubber
BTEX	benzene, toluene, ethylbenzene, and ortho-, meta-, and para- xylenes
booleanizes	booleanize
balc'ny	balcony
buffer	buff
B-NICE	biological, nuclear / radiological, incendiary, chemical, and explosive agents
booleanized	booleanize
bashes the bishop	bash the bishop
BTEC	w:Business and Technology Education Council
barristas	baristas
brownshirt	Brownshirt
bade	bid
butchered	butcher
buriest	bury
bacchanalian	Bacchanalian
brattles	brattle
babbled	babble
bewaileth	bewail
buying into	buy into
brattled	brattle
Bates numbers	Bates number
babbles	babble
blingier	blingy
Balkanizes	Balkanize
brothuh	brother
blinde	blind
brutified	brutify
beclogs	beclog
Balkanized	Balkanize
bouching	bouche
bigged up	big up
blinds	blind
Byzantinizing	Byzantinize
belabouring	belabour
boggest	bog
blanketing	blanket
bestialised	bestialise
batting away	bat away
burglarizing	burglarize
bestialises	bestialise
bepuzzling	bepuzzle
buttled	buttle
breaks bad	break bad
beseeming	beseem
bombs	bomb
brusquer	brusque
buttles	buttle
bettest	bet
backsources	backsource
behoves	behove
backsourced	backsource
befies	befie
buffeting	buffet
behoved	behove
bringing home	bring home
bugles	bulge
bustin'	busting
bugled	bugle
bewilling	bewill
bepuffs	bepuff
bastinadoed	bastinado
benetted	benet
bastinadoes	bastinado
bankr.	bankruptcy
busting	bust
bedipped	bedip
benzbromorone	benzbromarone
besieging	besiege
breaking in	break in
bemads	bemad
bejanking	bejank
bedripped	bedrip
becudgels	becudgel
balcon	balcony
boad	bode
bewards	beward
bethanks	bethank
bomboora	bombora
brushes aside	brush aside
booby-trapped	boobytrap
bravened	braven
bekisses	bekiss
booms	boom
blondening	blonden
brainwashing	brainwash
braving	brave
befilms	befilm
blackmails	blackmail
bekissed	bekiss
backlighted	backlight
beblinding	beblind
backchanneled	backchannel
bequeaths	bequeath
bewins	bewin
breyde	braid
beworries	beworry
brushes by	brush by
befittest	befit
bowest	bow
bedrugging	bedrug
bridging	bridge
blizzarding	blizzard
burbling	burble
brilliantining	brilliantine
Britifying	Britify
begathers	begather
burthensome	burdensome
builds on	build on
bioneutralizing	bioneutralize
barbed	barb
bepurpled	bepurple
beducked	beduck
bauchling	bauchle
boosted	boost
brassed	brass
boxes someone's ears	box someone's ears
bepurples	bepurple
brain storms	brain storm
brasses	brass
Bobbittizing	Bobbittize
bruxing	brux
buggers	bugger
balderdashing	balderdash
begilds	begild
bastardizing	bastardize
bittest	bite
blethered	blether
backcrossing	backcross
being	be
barbecues	barbecue
BOH	back of house
BOM	byte order mark
belittleth	belittle
BCSM	w:Basic call state model
barbecued	barbecue
BOG	boots on the ground
betrayeth	betray
boxiest	boxy
bellyflopped	bellyflop
busieth	busy
biotreats	biotreat
blonded	blond
bitch-slaps	bitch-slap
bein'	be
beeswaxes	beeswax
buh-bye	bye-bye
boycotted	boycott
beeswaxed	beeswax
breastfeeds	breastfeed
bulletizes	bulletize
bejumbled	bejumble
baldened	balden
blunteth	blunt
bulletized	bulletize
biological-weapon	biological weapon
boorka	burka
brivetting	brivet
Broad.	broadcasting
belched	belch
bepainted	bepaint
babian	baboon
behuing	behue
beckons	beckon
beats to	beat to
belches	belch
beareth	bear
biased	bias
bedighted	bedight
Britpicking	Britpick
backchecking	backcheck
biases	bias
buckets down	bucket down
barbarizes	barbarize
betrimmed	betrim
bleepier	bleepy
burning	burn
barbered	barber
besat	besit
besaw	besee
body surfed	body surf
bristles	bristle
bivouacking	bivouac
betrays	betray
backtrailed	backtrail
behapping	behap
bebays	bebay
bought wolf tickets	buy wolf tickets
bespittled	bespittle
befilming	befilm
burnin'	burning
bioaccumulates	bioaccumulate
bestormed	bestorm
bunds	bund
becudgelling	becudgel
bebeasted	bebeast
bioaccumulated	bioaccumulate
browbeaten	browbeat
babooning	baboon
BLASTed	BLAST
blue jean	blue jeans
bedabbled	bedabble
boomiest	boomy
bumpered	bumper
bassooned	bassoon
bobbars	bobbar
bisected	bisect
beaming	beam
berghed	bergh
biassed	bias
betweeness	betweenness
beswathing	beswathe
bibbles	bibble
beaks	beak
bibbled	bibble
backshoots	backshoot
bocconcino	bocconcini
bewent	bego
bound on equip	bind on equip
blinkering	blinker
batooning	batoon
basened	basen
bluejacked	bluejack
begynne	begin
basenet	bascinet
beworrying	beworry
bumpiest	bumpy
baddest	bad
bonibell	bonnibel
blamestorming	blamestorm
broasting	broast
bethumping	bethump
bestorms	bestorm
brachy	Brachyrhaphis
bicystronic	bicistronic
boozed	booze
bitbucketing	bitbucket
bepeppering	bepepper
boozes	booze
beats down	beat down
blows up	blow up
Barbadosing	Barbados
broader	broad
buttoning up	button up
bescorned	bescorn
bealing	beal
busroute	bus route
buzzin'	buzzing
blearing	blear
begreases	begrease
beshrewing	beshrew
bookkept	bookkeep
berays	beray
branchest	branch
brick walled	brick wall
barding	bard
begreased	begrease
bearing on	bear on
bedoctoring	bedoctor
brawniest	brawny
buzzing	buzz
bravoed	bravo
bordered on	border on
bulged	bulge
bechances	bechance
brewest	brew
bechanced	bechance
brimmed	brim
BCNF	Boyce-Codd normal form
bapped	bap
beclouded	becloud
BCNU	bis-chloroethylnitrosourea
bliking	blike
baulks	baulk
boldly goes where no man has gone before	boldly go where no man has gone before
bluesifies	bluesify
bufodienolide	bufadienolide
begunking	begunk
batching	batch
bluesified	bluesify
being able to	be able to
befitting	befit
breathest	breathe
brogged	brog
beglamoured	beglamour
bejaded	bejade
batted out	bat out
Bremaining	Bremain
birdsits	birdsit
blemished	blemish
bewasting	bewaste
bekens	beken
bogs	bog
becalls	becall
bides	bide
bedumbs	bedumb
bells out	bell out
bided	bide
bonded	bond
blowbangs	blowbang
busticated	busticate
banjoing	banjo
bewailing	bewail
browns	brown
brickfilming	brickfilm
busticates	busticate
boom-boomed	boom-boom
bumping nasties	bump nasties
blotted	blot
begoing	bego
barmiest	barmy
beflayed	beflay
bogof	BOGOF
blacklisting	blacklist
bashed the bishop	bash the bishop
borrage	borage
baptising	baptise
beseemed	beseem
bushiest	bush
bethwacks	bethwack
burled	burl
biofabricated	biofabricate
blowdried	blowdry
backpaddling	backpaddle
blowdries	blowdry
biofabricates	biofabricate
bearproofing	bearproof
brought forth	bring forth
bummed	bum
benefittest	benefit
boomerangs	boomerang
blurring	blur
bodyjacked	bodyjack
bows	bow
bedashed	bedash
billetting	billet
blueing	blue
butt dialing	butt dial
bulliragging	bullirag
bit the bullet	bite the bullet
behooving	behoove
bks.	books
brainfucked	brainfuck
bruvver	brother
buffering	buffer
buggers up	bugger up
blackjacks	blackjack
Buybull	buybull
betweene	between
backreacts	backreact
burnt out	burn out
bouncier	bouncy
begged	beg
bends	bend
blued	blue
blowing away	blow away
BMs	BM
begger	beggar
bulbing	bulb
BMC	black-majority church
blacks	black
BMI	body mass index
BMO	black moving object
blacke	black
blue screen	blue screen of death
batted in	bat in
Batmobiled	Batmobile
bungles	bungle
belied	belie
baled out	bale out
beds out	bed out
bungled	bungle
bumped	bump
betrothed	betroth
breezens	breezen
biggifying	biggify
breeziest	breezy
bitted	bitt
besmooching	besmooch
bestood	bestand
banninated	banninate
burrowed	burrow
bespeeding	bespeed
bleeped	bleep
biphosphanate	biphosphonate
browns out	brown out
bepraises	bepraise
bestudded	bestud
bepraised	bepraise
beglamours	beglamour
birdwatched	birdwatch
bibliographick	bibliographic
bioimpedence	bioimpedance
blowing a fuse	blow a fuse
blags	blag
birdwatches	birdwatch
bloomest	bloom
briskens	brisken
backsighting	backsight
beblasts	beblast
biarchy	diarchy
binge eating	binge eat
birdlimed	birdlime
Brazilian waxing	Brazilian wax
B&H	building
B&M	brick and mortar
birdlimes	birdlime
bewetted	bewet
belting out	belt out
bunkoed	bunko
backscratching	backscratch
brining	brine
bewastes	bewaste
becurtained	becurtain
basicly	basically
begoring	begore
bewasted	bewaste
bhp	brake horsepower
boosed	boose
blacknesse	blackness
behews	behew
batcape	Batcape
bejeweling	bejewel
bats a thousand	bat a thousand
bouncing	bounce
bucklered	buckler
butterflies	butterfly
birrs	birr
boldliest	boldly
balkanizes	balkanize
bustles	bustle
beshrouded	beshroud
balkanized	balkanize
bitchette	bitch
BBA	balanced budget amendment
blunting	blunt
bustled	bustle
bilgiest	bilgy
BlackBerrying	BlackBerry
beguyled	beguyle
burocrat	bureaucrat
beguyles	beguyle
bleachier	bleachy
blended	blend
ballsing	balls
bips	bip
blecks	bleck
backloads	backload
bespirting	bespirt
bluejacking	bluejack
bidden	bide
beams	beam
banned	ban
beblest	bebless
books it	book it
becudgeled	becudgel
Bn.	bassoon
bezaunt	bezant
besoming	besom
besteals	besteal
bleepiest	bleepy
bromating	bromate
belled	bell
beducks	beduck
banking	bank
blossoms	blossom
brass-necked	brass-neck
breading	bread
bundling	bundle
bandying around	bandy around
browzes	browze
besighs	besigh
bears in with	bear in with
boggiest	boggy
browzed	browze
buttwelded	buttweld
boxhauled	boxhaul
bone-marrow	bone marrow
bedunged	bedung
biotransformed	biotransform
brabbling	brabble
bespirted	bespirt
begnaws	begnaw
boards out	board out
buoys	buoy
brewing	brew
ballistæ	ballista
begnawn	begnaw
blousiest	blousy
blurbed	blurb
bemocked	bemock
bites the bullet	bite the bullet
burn-baited	burn-beat
befreeing	befree
bethralls	bethrall
bejeweled	bejewel
backing up	back up
bely	belie
builder's	builder's tea
basepaired	basepair
bluescreened	bluescreen
bissextile	leap year
blebbed	bleb
bloops	bloop
backtiming	backtime
brocades	brocade
basifying	basify
budges	budge
bwoys	boys
brocaded	brocade
broken the ice	break the ice
basilling	basil
budged	budge
bespangling	bespangle
backing	back
bulk billing	bulk bill
byefe	beef
binding	bind
bawdier	bawdy
backake	backache
busted a nut	bust a nut
bespotted	bespot
bethanking	bethank
brusker	brusk
bowed and scraped	bow and scrape
billeting	billet
barned	barn
bycicle	bicycle
birthed	birth
biomagnifying	biomagnify
beloading	beload
briefest	brief
burglaring	burglar
bouffed	bouffe
bescraping	bescrape
buzzeth	buzz
bawls	bawl
boxes the compass	box the compass
blown up someone's phone	blow up someone's phone
breaks bread	break bread
biographied	biography
bachs	bach
back-channeled	back-channel
benothinged	benothing
bemourns	bemourn
BLIS	blind spot information system
bedropt	bedrop
bedrops	bedrop
blacke sanctus	black sanctus
befuddles	befuddle
brutalism	Brutalism
bandlimitness	bandlimitedness
blue-skied	blue-sky
becomes one flesh	become one flesh
banalising	banalise
bellyaches	bellyache
bewhispered	bewhisper
babyworn	babywear
Birminghamising	Birminghamise
blowtorching	blowtorch
babywore	babywear
bepowders	bepowder
bespewing	bespew
barricading	barricade
blattered	blatter
bushwacks	bushwack
barriered	barrier
befrozen	befreeze
bruited	bruit
balls	ball
backscratches	backscratch
bedancing	bedance
beaten as one	beat as one
bereftest	bereave
behappened	behappen
becharms	becharm
brivetted	brivet
bousy	boozy
bungs	bung
broggles	broggle
broggled	broggle
bloatiest	bloaty
bd	boulevard
bf	boldface
bg	background
bb	baby
bn	brand new
bj	blow job
bk	bad kid
bt	but
bu	bushel
bw	birth weight
bp	basis point
biofiltering	biofilter
brake testing	brake test
beveiled	beveil
breasted	breast
besoms	besom
bookmatches	bookmatch
barocycles	barocycle
beatboxing	beatbox
BPaaS	business
bookmatched	bookmatch
brings up short	bring up short
barocycled	barocycle
besonged	besong
bourgeoisifies	bourgeoisify
betrayest	betray
BKN	broken
bargaining	bargain
biol	biology
bulletinized	bulletinize
beating off	beat off
bourgeoisified	bourgeoisify
Bates numbering	Bates number
bridesmaids	bridesmaid
becrawls	becrawl
bulletinizes	bulletinize
bass cliff	bass clef
brute forced	brute force
butters	butter
brute forces	brute force
believedst	believe
botanizing	botanize
begays	begay
blacketh	black
burrows	burrow
bio.	biography
blunging	blunge
bewigging	bewig
biofabricating	biofabricate
befied	befie
betid	betide
belloweth	bellow
beskirted	beskirt
breastapo	Breastapo
beating around the bush	beat around the bush
bedhopping	bedhop
bipartison	bipartisan
blood-type	blood type
beagling	beagle
beblistering	beblister
bussing	buss
bosoming	bosom
battier	batty
bowdlerising	bowdlerise
battening	batten
BOE	barrel of oil equivalent
bedeviled	bedevil
bobbitize	Bobbittize
barkled	barkle
buzziest	buzzy
BLAST	blast
bibblebabbled	bibblebabble
backchatting	backchat
befrosts	befrost
bites off	bite off
blunderbussing	blunderbuss
bibblebabbles	bibblebabble
besteads	bestead
bewraid	bewrayed
befilthing	befilth
burgler	burglar
burgles	burgle
backreferencing	backreference
betining	betine
burgled	burgle
book-signing	book signing
bought time	buy time
booted out	boot out
bejuggling	bejuggle
bunnian	bunion
BNWT	brand new with tags
bit off	bite off
bemusing	bemuse
bemoans	bemoan
blaspheming	blaspheme
bolshevizing	bolshevize
backshadowing	backshadow
buzz-bombing	buzz-bomb
benumbing	benumb
beriming	berime
Bangalores	Bangalore
Bangalored	Bangalore
bird-dogs	bird-dog
blegged	bleg
blandishes	blandish
blown away	blow away
bouncable	bounceable
blandished	blandish
bespattering	bespatter
bingeing	binge
biographised	biographise
banana split	bullshit
bedhops	bedhop
biographises	biographise
bookkeeping	bookkeep
buffered	buffer
bodybuilds	bodybuild
beautie	beauty
blightening	blighten
bird-dogged	bird-dog
blockiest	blocky
bloweth	blow
binged	binge
blubbered	blubber
bastarded	bastard
binges	binge
boogieing	boogie
bastinading	bastinade
bobbing	bob
babs	bab
bubbing	bub
borning	born
bookmarks	bookmark
bauchles	bauchle
biggening	biggen
benefitting	benefit
bauchled	bauchle
bodyblocking	bodyblock
bibliophil	bibliophile
bestrown	bestrew
brick walling	brick wall
begreasing	begrease
back-burnered	back-burner
biggifies	biggify
battereth	batter
bowlderised	bowdlerised
beckoned	beckon
biggified	biggify
blvd	boulevard
BCAA	branched-chain amino acid
bolstered	bolster
bulldogged	bulldog
bullmastiff	Bullmastiff
benj	bhang
bummed around	bum around
bilinguar	bilingual
basilled	basil
barodenervated	barodenervate
bird dogged	bird dog
blockt	block
blocks	block
bronzing	bronze
bass-relief	bas relief
bumbles	bumble
biggest-dicked	big-dicked
bussell	bustle
bumbled	bumble
bekiss'd	bekiss
blinned	blin
beachballed	beachball
begged off	beg off
burpin'	burping
bailed out	bail out
bombilating	bombilate
blazens	blazen
botherin'	bothering
bushelling	bushel
broiling	broil
bodges	bodge
back-channels	back-channel
barhops	barhop
BVetMed	Bachelor of veterinary
besays	besay
bethumbing	bethumb
bothering	bother
bedamned	bedamn
bas	ba
bawhorse	bathorse
boosing	boose
bicinchronic	bicinchoninic
bioluminometic	bioluminometric
bemans	beman
bricked up	brick up
bedyeing	bedye
bannering	banner
bespies	bespy
blackballing	blackball
basidomycete	basidiomycete
Bowdlerized	Bowdlerize
booke	book
belocking	belock
bespotting	bespot
bums	bum
béarnaise	A shortening
books	book
bedazing	bedaze
bipartitioning	bipartition
benefiting	benefit
bunched	bunch
beleaped	beleap
bekenned	beken
boards up	board up
bunches	bunch
binkying	binky
bevomited	bevomit
brassiest	brassy
baching	bach
barrel jumps	barrel jump
bothered	bother
backshooting	backshoot
biomineralized	biomineralize
bombilated	bombilate
blew over	blow over
bylander	bilander
bombilates	bombilate
biomineralizes	biomineralize
buglest	bugle
beclapping	beclap
blown	blow
burnettizing	burnettize
becomest	become
bo-peeps	bo-peep
blows	blow
beleaguering	beleaguer
brought home	bring home
behats	behat
behaves	behave
bailiffwick	bailiwick
bellhopped	bellhop
besmuts	besmut
branding	brand
behaved	behave
biologizes	biologize
burglarized	burglarize
biologized	biologize
buckles down	buckle down
boobytraps	boobytrap
burglarizes	burglarize
botox	Botox
benzole	benzol
blew out	blow out
broad reached	broad reach
bespreads	bespread
briefing	brief
besees	besee
batoning	baton
brevetting	brevet
bryozan	bryozoan
biasses	bias
BIC	bureau
bamming	bam
BIP	blunt impact projectile
babez	babes
bioreduced	bioreduce
buckraming	buckram
bigamized	bigamize
better-known	well-known
bizarrest	bizarre
bradyarrythmia	bradyarrhythmia
bigamizes	bigamize
bicomissural	bicommissural
benzanidine	benzamidine
bagsying	bagsy
breh	bro
bleaker	bleak
bred	breed
beaning	bean
bubbleth	bubble
BHT	butylated hydroxytoluene
bunged up	bung up
brer	brother
best-informed	well-informed
bepaints	bepaint
bonged	bong
biographizes	biographize
breaststroking	breaststroke
biographized	biographize
bikes	bike
burnished	burnish
bleachiest	bleachy
Barbadoses	Barbados
back-hands	back-hand
buttons	button
burnishes	burnish
Barbadosed	Barbados
bisbenzamide	bisbenzimide
blackholing	blackhole
bonds	bond
bull-bar	bull bar
bronchodilates	bronchodilate
builds upon	build upon
begettest	beget
bronchodilated	bronchodilate
basking	bask
bonjoured	bonjour
bettereth	better
bevoicing	bevoice
biennary	biennial
battens down	batten down
besoothing	besoothe
bastes	baste
banefullest	baneful
benmost	ben
blowdrying	blowdry
broodier	broody
brocked	brock
buggering off	bugger off
bedimpled	bedimple
buckdanceing	buckdance
butts	butt
brought on	bring on
brocks	brock
bedimples	bedimple
befettering	befetter
boyed	boy
bucked	buck
brought down	bring down
beprosing	beprose
beshiting	beshite
bespurting	bespurt
balderdashes	balderdash
botted	bot
begirding	begird
backspaces	backspace
backpatching	backpatch
balderdashed	balderdash
backspaced	backspace
blazest	blaze
Batmobiling	Batmobile
birdysits	birdysit
becurling	becurl
billhooked	billhook
braggadoccio	braggadocio
booziest	boozy
backdating	backdate
bebarked	bebark
blueprinting	blueprint
boulted	boult
busted ass	bust ass
bassaw	bashaw
brangled	brangle
behooveth	behoove
beweds	bewed
bawwed	baww
bekissing	bekiss
blacklegging	blackleg
bookends	bookend
botchiest	botchy
bursten	burst
bedimpling	bedimple
bronzed	bronze
bursted	burst
ballbusts	ballbust
bedrizzled	bedrizzle
bolding	bold
backhanding	backhand
bedrizzles	bedrizzle
barreled	barrel
bodysurfs	bodysurf
biffing	biff
beshrouds	beshroud
buffed the muffin	buff the muffin
bacterized	bacterize
birded	bird
bobbitts	bobbitt
briefens	briefen
bagsing	bags
boding	bode
bring'st	bringest
bought out	buy out
bought into	buy into
bronzes	bronze
bebathed	bebathe
birdiesitting	birdiesit
better-built	well-built
besouled	besoul
boxhauls	boxhaul
blotchiest	blotchy
beclouding	becloud
backhauls	backhaul
braized	braize
bovrilizes	bovrilize
bakhshishing	bakhshish
bovrilized	bovrilize
bibbling	bibble
binds on pickup	bind on pickup
bewhacked	bewhack
brightened up	brighten up
bigamizing	bigamize
blatherin'	blathering
BCD	bad
brightenest	brighten
burthened	burthen
backcasting	backcast
bedazzling	bedazzle
bartending	bartend
bats one thousand	bat one thousand
bulga	bulgur
blathering	blather
bedumbing	bedumb
biomedicalizing	biomedicalize
Brexits	Brexit
blowin'	blowing
b'lieved	b'lieve
blending	blend
bled out	bleed out
beliest	belie
bedding	bed
backwings	backwing
broken wind	break wind
branchiostegial	branchiostegal
blurrs	blurr
bunking	bunk
blenked	blenk
burnt the candle at both ends	burn the candle at both ends
benefitted	benefit
browned out	brown out
brokering	broker
befringing	befringe
bo-peeping	bo-peep
basepairs	basepair
bepitied	bepity
beshorn	beshear
beladied	belady
besomed	besom
bepities	bepity
bancke	bank
bycatching	bycatch
bebaying	bebay
bullets	bullet
beteaches	beteach
balistically	ballistically
beladies	belady
biostimulated	biostimulate
bouged	bouge
booed	boo
backscattering	backscatter
bouges	bouge
bouget	budget
blinging out	bling out
burlier	burly
buffs the muffin	buff the muffin
biocalcifies	biocalcify
broomier	broomy
blightens	blighten
brownier	browny
bigfooted	bigfoot
beats it	beat it
blottos	blotto
bounden	bind
breathier	breathy
bagged	bag
begg'd	beg
baptizeth	baptize
builtest	build
beeped	beep
babywears	babywear
bursts into tears	burst into tears
backtrolls	backtroll
beating up	beat up
bedyes	bedye
Bowdlerizes	Bowdlerize
beghosting	beghost
brouze	browse
buzzsawed	buzzsaw
bedyed	bedye
buuut	but
backwinded	backwind
burglared	burglar
bloud	blood
broodiest	broody
babbed	bab
backchats	backchat
bearin'	bearing
bit-bucket	bit bucket
bailing	bail
baffling	baffle
building on	build on
bruits	bruit
biodecays	biodecay
bringing owls to Athens	bring owls to Athens
becomsing	becomse
bangtailed	bangtail
bastardizes	bastardize
bioprospected	bioprospect
begifting	begift
bastardized	bastardize
bottled up	bottle up
Bartramian sandpiper	bartramian sandpiper
bodder	bother
breaking out	break out
breastier	breasty
Bouddhist	Buddhist
bumetamide	bumetanide
bizzare	bizarre
ball out	bawl out
bordering on	border on
Bouddhism	Buddhism
broke and entered	break and enter
bluescreens	bluescreen
BWR	boiling water reactor
BWS	Beckwith-Wiedemann syndrome
brashest	brash
barmed	barm
backlisting	backlist
barmen	barman
BWC	big white cock
banisht	banish
bowing out	bow out
BWM	Biel water maze
butling	butle
blistering	blister
bambooing	bamboo
bentches	bentch
brimfull	brimful
buttwelds	buttweld
batmobiling	batmobile
blanked	blank
bentched	bentch
bodyblocks	bodyblock
backlashed	backlash
bewildered	bewilder
breaks the ice	break the ice
backreferenced	backreference
by and bye	by and by
backlashes	backlash
Buddhizing	Buddhize
bubbling	bubble
bestraddling	bestraddle
belaboring	belabor
blaspheme	blasphemy
beslubbering	beslubber
beclawing	beclaw
bowled over	bowl over
butts in	butt in
bumbard	bombard
beclowned	beclown
bespots	bespot
betas	beta
buildedst	build
batches	batch
buys up	buy up
betterer	better
bioirrigates	bioirrigate
browsing	browse
bettered	better
beautifuller	beautiful
baulkier	baulky
barged in	barge in
beflecked	befleck
bogarts	bogart
brn	brown
biddeth	bid
bleariest	bleary
balsaming	balsam
back-annotated	back-annotate
bundles	bundle
back-annotates	back-annotate
bloomin'	blooming
blueberried	blueberry
bundled	bundle
betalked	betalk
blouds	bloud
bageled	bagel
brings up	bring up
beblubbered	beblubber
brightley	brightly
blocking	block
borenes	borene
boobies	booby
bunnier	bunny
burned the midnight oil	burn the midnight oil
banged on	bang on
bespells	bespell
bartended	bartend
blooming	bloom
buggered up	bugger up
buddy breathing	buddy breathe
betined	betine
blowsier	blowsy
bedaquilline	bedaquiline
befuddling	befuddle
betines	betine
burnt the midnight oil	burn the midnight oil
buffler	buffalo
boate	boat
bandaging	bandage
buffled	buffle
boats	boat
brined	brine
bares	bare
barer	bare
bday	birthday
boughten	buy
bared	bare
becrawled	becrawl
Bhuddism	Buddhism
balancing	balance
bursectomized	bursectomize
begalled	begall
Braminic	Brahminic
Balkanised	Balkanise
brandishest	brandish
buttfucked	buttfuck
babifying	babify
Balkanises	Balkanise
bombing	bomb
befallen	befall
bridlest	bridle
brawling	brawl
busts ass	bust ass
bitchinest	bitchin
bunching	bunch
blobbed	blob
bans	ban
bestarring	bestar
borking	bork
bushwalked	bushwalk
blobber	blubber
breadthens	breadthen
biographise	biographize
brocking	brock
bolted	bolt
believes in	believe in
behalfe	behalf
batmobiled	batmobile
backgrounds	background
becatching	becatch
batmobiles	batmobile
behoveth	behove
blating	blate
braiding	braid
bonjouring	bonjour
bludging	bludge
baling	bale
bedrizzling	bedrizzle
backed up	back up
beefing	beef
bescribbling	bescribble
buoyed	buoy
B.Dr.	bass drum
baby-sits	baby-sit
BBQs	BBQ
blowtorches	blowtorch
balladed	ballad
Birminghamises	Birminghamise
begallows	begallow
bowstringing	bowstring
Birminghamised	Birminghamise
bespewed	bespew
blowtorched	blowtorch
bichromatized	bichromatize
bummery	bottomry
baltic	Baltic
benchmarking	benchmark
beknights	beknight
bioinvading	bioinvade
befreezes	befreeze
blossomed	blossom
buttressing	buttress
baptises	baptise
boonder	bandar
baptised	baptise
blurts	blurt
brown-bagged	brown-bag
belauded	belaud
bioconcentrated	bioconcentrate
binned	bin
bousing	bouse
bollockses up	bollocks up
bending the truth	bend the truth
big upped	big up
backcombed	backcomb
blitting	blit
beghosted	beghost
binds	bind
buttwelding	buttweld
bolshiest	bolshie
bonsaied	bonsai
bloodying up	bloody up
bedrove	bedrive
beflagged	beflag
baned	bane
brought off	bring off
befingered	befinger
biotransforming	biotransform
burnettizes	burnettize
bemingling	bemingle
batmanned	batman
biomineralizing	biomineralize
backquoting	backquote
bittiest	bitty
biographising	biographise
bootlicking	bootlick
blowing out	blow out
besliming	beslime
bleved	bleve
bark at the wrong tree	Misconstruction
bosonized	bosonize
beaten a dead horse	beat a dead horse
braizing	braize
bosonizes	bosonize
behaps	behap
bestaining	bestain
blotting	blot
bangiest	bangy
belimbs	belimb
bivouacs	bivouac
botanises	botanise
blighted	blight
blanking	blank
blading	blade
belching	belch
bluejacks	bluejack
beheads	behead
belaboured	belabour
beteems	beteem
bunyak	alternative form
banhammering	banhammer
blanquet	blanquette
bent the rules	bend the rules
blousing	blouse
backloaded	backload
besows	besow
basipedal	basipetal
brainfucks	brainfuck
beblasting	beblast
bouldly	boldly
bestolen	besteal
blimpier	blimpy
blipped	blip
bonked	bonk
busts a nut	bust a nut
bemuddles	bemuddle
beats a dead horse	beat a dead horse
bracing	brace
BUN	blood, urea, nitrogen
BUC	Bàng-uâ-cê
bridesmaiding	bridesmaid
blights	blight
broad reaches	broad reach
bangier	bangy
blightened	blighten
beluin	belluine
bewinning	bewin
bethumped	bethump
bushbashed	bushbash
bumfucked	bumfuck
burough	borough
bestows	bestow
braaiing	braai
boppier	boppy
banalised	banalise
betook	betake
beheaded	behead
broadens	broaden
bestowe	bestow
broadening	broaden
better-hung	well-hung
bemercying	bemercy
brickier	bricky
bedrabbling	bedrabble
bearing down	bear down
beknowing	beknow
Brittish	British
bandishing	bandish
backsheeshing	backsheesh
bought and paid for	buy and pay for
bilocates	bilocate
barging in	barge in
brightening	brighten
backfilling	backfill
bilocated	bilocate
bespouts	bespout
buzz-bombed	buzz-bomb
bewitcheth	bewitch
beweighs	beweigh
bemixing	bemix
blagged	blag
beholds	behold
bemires	bemire
beetles	beetle
been had	be had
beetled	beetle
bastid	bastard
bemired	bemire
broke bad	break bad
besings	besing
begazes	begaze
backtabs	backtab
barbarized	barbarize
biled	bile
bedighting	bedight
brisks	brisk
blamed	blame
begazed	begaze
boltest	bolt
beaconed	beacon
burbles	burble
big-notes	big-note
boometh	boom
begroaned	begroan
backgrounded	background
big-noted	big-note
burbled	burble
bandier	bandy
bandies	bandy
breaking one off	break one off
bestuds	bestud
breakier	breaky
backchecks	backcheck
bandied	bandy
beautifying	beautify
breaking water	break water
bookmarked	bookmark
boobfeeding	boobfeed
bridesmaided	bridesmaid
baselined	baseline
belongs	belong
borderlining	borderline
boxed	box
beating one's swords into plowshares	beat one's swords into plowshares
blabbling	babbling
bassed	bass
balmiest	balmy
boxes	box
bedungs	bedung
bearing out	bear out
bogeys	bogey
bpm	beat per minute
bpp	bits per pixel
bps	basis points
bombastick	bombastic
burglarising	burglarise
blockheads	blockhead
bedizzening	bedizzen
backgammoned	backgammon
blackbirding	blackbird
brassens	brassen
bottom edges	bottom edge
bottom edged	bottom edge
besmooths	besmooth
beslaps	beslap
boffing	boff
begging off	beg off
bristlier	bristly
bloudie	bloody
beardiest	beardy
birdysitting	birdysit
blue-skying	blue-sky
balkanize	Balkanize
breaded	bread
banked	bank
bore up	bear up
britting	brit
bethinking	bethink
bearest	bear
birdiesits	birdiesit
beatin'	beating
BMing	BM
becomin'	becoming
begaumed	begaum
balances	balance
blootering	blooter
bolixed up	bolix up
Bros.	brothers
bitting	bitt
balanced	balance
bouns	boun
bloody heck	bloody hell
bioconcentrating	bioconcentrate
backslideth	backslide
betterfies	betterfy
betterfied	betterfy
birdysat	birdysit
backflushed	backflush
becoming	become
bolloxing	bollox
bedrinks	bedrink
braggest	brag
bypassing	bypass
bigmanism	autocracy
beating down	beat down
braver	brave
bobaunce	bobance
boulework	buhl work
br'er	brother
bleving	bleve
braved	brave
bloviated	bloviate
battell	battle
blingiest	blingy
branchier	branchy
boteless	bootless
biotested	biotest
Barnumizes	Barnumize
blotchier	blotchy
butyrated	butylated
beweighed	beweigh
bcc'ing	bcc
babelizing	babelize
Barnumized	Barnumize
bulling	bull
brothers	brother
blottoed	blotto
boomier	boomy
backing off	back off
blottoes	blotto
boogering up	booger up
benegroed	benegro
BEVx	battery electric vehicle with extender
bestowed	bestow
bacterises	bacterise
big-noting	big-note
buckrammed	buckram
Bishop	bishop
beds	bed
banquets	banquet
beslobbered	beslobber
bacterised	bacterise
breathes	breathe
brownian	Brownian
baited	bait
bedrugged	bedrug
bird dogging	bird dog
beliking	belike
biked	bike
bescorching	bescorch
bagpack	backpack
blowing down	blow down
burnettized	burnettize
barbacked	barback
bradypnœa	bradypnea
bygly	bigly
backshished	backshish
blended in	blend in
bearheaded	bareheaded
bestialized	bestialize
bad-mouthed	bad-mouth
bestializes	bestialize
bhindi	okra
banalise	banalize
bumfucking	bumfuck
blazonest	blazon
besmiled	besmile
besmiles	besmile
botanising	botanise
broke up	break up
breezes	breeze
Brachman	Brahman
bleakening	bleaken
broileth	broil
brigaded	brigade
back-sweetening	back-sweeten
beclothing	beclothe
blotches	blotch
brings up against	bring up against
beachiest	beachy
BMEP	brake mean effective pressure
blotched	blotch
buccaniers	buccanier
begunnest	begin
builds castles in the air	build castles in the air
bespiced	bespice
broching	broche
bespices	bespice
bombinated	bombinate
breezed	breeze
bunding	bund
bemeant	bemean
bemeans	bemean
brookest	brook
brûléed	brûlée
bizzarely	bizarrely
bescrawling	bescrawl
bowing	bow
BSc	Bachelor of Science
bigs	big
bosomiest	bosomy
BSS	business support system
BSL	breed#Noun
BSI	body substance isolation
bloqued	bloque
BSE	backscattered electrons
BSG	blue supergiant
BSA	bovine serum albumin
bellini	Bellini
bandsawed	bandsaw
bandsawn	bandsaw
boxed someone's ears	box someone's ears
BS.	Balto-Slavic
bombs out	bomb out
bluffs out	bluff out
bemoaning	bemoan
besticking	bestick
breede	breed
bushhammered	bushhammer
bowled	bowl
breeds	breed
boilest	boil
beating as one	beat as one
bowked	bowk
blindfolds	blindfold
balkanised	balkanise
bagpacker	backpacker
bejesuits	bejesuit
bescribbles	bescribble
baby-sat	baby-sit
balkanises	balkanise
bescribbled	bescribble
backsourcing	backsource
barkier	barky
bioimmures	bioimmure
brazed	braze
brushiest	brushy
burrowing	burrow
brazes	braze
bioimmured	bioimmure
banishest	banish
BluRay	Blu-ray
bleeds white	bleed white
bentching	bentch
begives	begive
bookcrossing	bookcross
belfery	belfry
bespoused	bespouse
brawlest	brawl
besainting	besaint
back-translating	back-translate
bespouses	bespouse
bestains	bestain
bedded down	bed down
bawble	bauble
bowing and scraping	bow and scrape
bepats	bepat
bulldogging	bulldog
baston	baton
brown bags	brown bag
blackbirds	blackbird
birthdays	birthday
backbitten	backbite
broadcasts	broadcast
bigfoots	bigfoot
backwinged	backwing
bowssening	bowssen
ballparked	ballpark
bilks	bilk
boguing	bogue
bottoms the house	bottom the house
bodyboards	bodyboard
burps	burp
bursts	burst
betoiled	betoil
bursts into flame	burst into flame
burbliest	burbly
backstopping	backstop
beleaguring	beleagure
bandies around	bandy around
ballses around	balls around
ballsed on	balls on
becarving	becarve
backpeddle	backpedal
barters	barter
building upon	build upon
bodyboarding	bodyboard
bekase	because
brushes one's teeth	brush one's teeth
berhyming	berhyme
buildeth	build
beflew	befly
bruiting	bruit
bugged out	bug out
befled	beflee
beshouted	beshout
bestarred	bestar
breaking bad	break bad
beknighted	beknight
beesome	besom
buprenorphrine	buprenorphine
benefited	benefit
beest	be
blins	blin
bandolined	bandoline
basted	baste
blackenizes	blackenize
brain stormed	brain storm
bioremediated	bioremediate
beslabbered	beslabber
blackening	blacken
blackenized	blackenize
backwatering	backwater
bodyguarded	bodyguard
brains	brain
back-sweetened	back-sweeten
blasphemest	blaspheme
balds	bald
brandled	brandle
braine	brain
becoming one flesh	become one flesh
break downs	breakdowns
beflowering	beflower
browsed	browse
bifunctionalizing	bifunctionalize
bisulfated	bisulfate
browses	browse
born on	bear on
boult	bolt
bugs	bug
bould	bold
baketh	bake
BASIL	biphasic acid scavenge
bulked out	bulk out
bucksom	buxom
berobs	berob
batted for both sides	bat for both sides
breakdanced	breakdance
baldest	bald
big-enchilada	big enchilada
bending the rules	bend the rules
beholdest	behold
bitching	bitch
bleared	blear
bindaloo	vindaloo
beknaving	beknave
backslid	backslide
bubbliest	bubbly
bribest	bribe
bearding	beard
bedogging	bedog
bishops	bishop
back-annotating	back-annotate
blimpiest	blimpy
bonsaiing	bonsai
bops	bop
broke one off	break one off
banninating	banninate
banters	banter
beseems	beseem
bewigs	bewig
broke loose	break loose
breadcrumbs	breadcrumb
bookplating	bookplate
bodychecks	bodycheck
bowelled	bowel
bioneered	bioneer
bankrupting	bankrupt
BSMS	bus-service management system
bassoons	bassoon
balls out	ball out
brownified	brownify
banqueteers	banqueteer
beleaguers	beleaguer
beshouting	beshout
bespoiling	bespoil
brown-recluse	brown recluse
backburned	backburn
becurled	becurl
befo	before
beating to	beat to
Boston brahmin	Boston Brahmin
breadboarding	breadboard
baits	bait
bedoctored	bedoctor
breeched	breech
breaks one's lance	break one's lance
backfiring	backfire
bespelling	bespell
bounds	bound
blue-penciling	blue-pencil
biassing	bias
betideth	betide
beatboxes	beatbox
booleanised	booleanise
bringeth	bring
bringing low	bring low
beatboxed	beatbox
blennorrhœal	blennorrhoeal
borrowedst	borrow
bogotified	bogotify
bechilled	bechill
bejading	bejade
boning	bone
binge-watching	binge-watch
bumps nasties	bump nasties
bilgier	bilgy
broid	braid
bogotifies	bogotify
bound over	bind over
beshitting	beshit
braces aback	brace aback
belaps	belap
bayts	bayt
bulgier	bulgy
blown down	blow down
bucks for	buck for
bringing down the hammer	bring down the hammer
booby-trapping	booby-trap
brothering	brother
becursing	becurse
brain-storming	brain-storm
bepelting	bepelt
bepinching	bepinch
barn-owl	barn owl
bovrilises	bovrilise
buolt	bolt
balanaeopterid	balaenopterid
bowwowing	bowwow
befooled	befool
baboo	babu
Barnumising	Barnumise
Birminghamizing	Birminghamize
blondens	blonden
baying	bay
boreth	bore
ballading	ballad
bedizening	bedizen
bayoneted	bayonet
blinkers	blinker
blecked	bleck
bought a dog and barked oneself	buy a dog and bark oneself
bobared	bobar
barbacan	barbican
bickered	bicker
breaking with	break with
BCer	British Columbian
backstitching	backstitch
bad wrap	bad rap
bona fida	bona fide
backheeling	backheel
blue petered	blue peter
blue print	blueprint
busked	busk
banck	bank
bloodlets	bloodlet
botanick	botanic
bestridden	bestride
baning	bane
brickiest	bricky
bebloods	beblood
Batmobiles	Batmobile
backtalked	backtalk
beaming up	beam up
bagpiped	bagpipe
believeableness	believableness
breasted one's cards	breast one's cards
brought about	bring about
beveling	bevel
bezoard	bezoar
besmutching	besmutch
brivets	brivet
black-ice	black ice
benightens	benighten
blatently	blatantly
betokeneth	betoken
beaten the system	beat the system
bedamps	bedamp
blue lighting	blue light
barbecuing	barbecue
buck danced	buck dance
basest	base
beringed	bering
bullocking	bullock
buck dances	buck dance
bleeds out	bleed out
beatest	beat
bulletproofed	bulletproof
blemisheth	blemish
boobfed	boobfeed
blearest	blear
backscratched	backscratch
byde	bide
bruitifying	bruitify
bobbed	bob
babysitted	babysit
banked up	bank up
belacing	belace
breaming	bream
befriendest	befriend
braking	brake
bootlicks	bootlick
bullirags	bullirag
balked	balk
breasting one's cards	breast one's cards
bleedeth	bleed
bucklest	buckle
busticating	busticate
beseeches	beseech
blasted off	blast off
BLASTing	BLAST
blessest	bless
bestems	bestem
bermed	berm
beseeched	beseech
backup	back up
Burmanizes	Burmanize
buys wolf tickets	buy wolf tickets
blowing up someone's phone	blow up someone's phone
bastocyst	blastocyst
bensonase	benzonase
babbited	babbit
Balkanising	Balkanise
Burmanized	Burmanize
bossed around	boss around
beskirting	beskirt
beckon call	beck and call
bemuffles	bemuffle
bootjacked	bootjack
blarneying	blarney
barnstorms	barnstorm
bucketing	bucket
brassing	brass
bitier	bitey
Blu-Tacks	Blu-Tack
barking up the wrong tree	bark up the wrong tree
battlest	battle
blinning	blin
bushbashing	bushbash
begunked	begunk
berascalling	berascal
backcombs	backcomb
beliefe	belief
b*llshit	bullsh*t
bioactivated	bioactivate
bioactivates	bioactivate
builders	builders' tea
beguileth	beguile
beshamed	beshame
bamboozled	bamboozle
beshames	beshame
bawled	bawl
beleft	beleave
bamboozles	bamboozle
beseemest	beseem
buildin'	building
blackmarked	blackmark
backheels	backheel
billowiest	billowy
bammed	bam
Br.	brief
becasting	becast
brails	brail
ballarags	ballarag
brought up against	bring up against
begs off	beg off
bringing on	bring on
bearing witness	bear witness
backgammoning	backgammon
beastiality	bestiality
bromized	bromize
broched	broche
brassening	brassen
bequested	bequest
blissfuller	blissful
blethers	blether
bidendate	bidentate
blown a fuse	blow a fuse
belabour'd	belabour
bejewelled	bejewel
back-sweetens	back-sweeten
bethralling	bethrall
Brown	brown
blueberries	blueberry
backpedaling	backpedal
Botoxing	Botox
blotteth	blot
batched	batch
belaying	belay
beslabbers	beslabber
begauded	begaud
brouzing	brouze
bombarded	bombard
bulder	boulder
backslided	backslide
bigging	big
bedips	bedip
bedipt	bedip
begot	beget
brothiest	brothy
biosynthesises	biosynthesise
breaks open	break open
bulldozing	bulldoze
bricks up	brick up
biosynthesised	biosynthesise
blustereth	bluster
bruisest	bruise
baksheeshing	baksheesh
busing	bus
benighting	benight
bullshittier	bullshitty
bipped	bip
belaces	belace
befriends	befriend
bedrew	bedraw
bed-hopped	bed-hop
becourages	becourage
borylating	borylate
betimbered	betimber
belly flopped	belly flop
beadiest	beady
bestrid	bestride
becouraged	becourage
blackbagging	blackbag
blundered	blunder
bowls	bowl
brown-nosed	brown-nose
babytalks	babytalk
blondened	blonden
backslaps	backslap
brown-noses	brown-nose
brassinosteriod	brassinosteroid
bicycled	bicycle
bringing a knife to a gunfight	bring a knife to a gunfight
bechides	bechide
biggers	bigger
bratticed	brattice
beeswaxing	beeswax
becries	becry
badarse	badass
becurtaining	becurtain
bovrilising	bovrilise
BWWM	black woman, white man
bituminized	bituminize
banistered	banister
bituminizes	bituminize
bequeathest	bequeath
birdying	birdie
bilking	bilk
bribed	bribe
binds up	bind up
brigues	brigue
batnipples	Batnipples
browner	brown
barkens	barken
brigued	brigue
browned	brown
brenning	bren
barracking	barrack
boatlifting	boatlift
belettered	beletter
beatifies	beatify
budgets	budget
beatified	beatify
bylde	build
bishoprick	bishopric
broadsealing	broadseal
bruitifies	bruitify
berated	berate
behote	behight
brooking	brook
bruitified	bruitify
birling	birl
bemudding	bemud
beshearing	beshear
beggarest	beggar
blown up	blow up
beflagging	beflag
bashin'	bashing
bitchingest	bitching
bemadams	bemadam
bewildereth	bewilder
bipolarising	bipolarise
bouging	bouge
black-bagging	black-bag
boned up	bone up
benifits	benefits
boarded up	board up
bullionizing	bullionize
breade	bread
banke	bank
blinketh	blink
bashing	bash
blown off steam	blow off steam
banks	bank
breads	bread
brandered	brander
burnt	burn
backpedalled	backpedal
bespelled	bespell
bowged	bowge
broidered	broider
backtimes	backtime
bezzles	bezzle
bowges	bowge
breaks the fourth wall	break the fourth wall
bezzled	bezzle
backtimed	backtime
bushwalks	bushwalk
bluebooked	bluebook
booted up	boot up
bends over	bend over
biodegraded	biodegrade
botched	botch
biodegrades	biodegrade
bummier	bummy
boaks	boak
botches	botch
bikejoring	bikejor
bewrapped	bewrap
broke bread	break bread
blackleaded	blacklead
broacht	broach
behowled	behowl
bedropped	bedrop
brazening	brazen
benightening	benighten
buffaloed	buffalo
bushwacking	bushwack
blest	bless
barrels	barrel
backreacting	backreact
bellyake	bellyache
BAMF	bad-ass
base-metal	base metal
bethinks	bethink
brain storming	brain storm
bickering	bicker
blabbering	blabber
buffers	buffer
bedripping	bedrip
blusheth	blush
blagging	blag
brokest	break
balled	ball
becovering	becover
blundering	blunder
bodychecked	bodycheck
bouldered	boulder
beguyle	beguile
bought off	buy off
bellowses	bellows
brightest	bright
bellowsed	bellows
beneficing	benefice
backchains	backchain
bescreening	bescreen
blackenest	blacken
beggars	beggar
bacterizes	bacterize
blunderin'	blundering
burying the hatchet	bury the hatchet
buffaloes	buffalo
blowing one's load	blow one's load
blemishing	blemish
bewizarded	bewizard
backshifting	backshift
buffing	buff
besteaded	bestead
bepommelled	bepommel
biofluorescing	biofluoresce
bourgeons	bourgeon
birfday	birthday
bridling	bridle
Bildungsroman	bildungsroman
breakest	break
blazoning	blazon
begriping	begripe
bowes	bow
bacterising	bacterise
begemmed	begem
bridg	bridge
battering	batter
backwound	backwind
becolouring	becolour
bridles	bridle
bedarkening	bedarken
bluened	bluen
bullionised	bullionise
bellweathers	bellwethers
betells	betell
besmudging	besmudge
bridled	bridle
brustling	brustle
bullionises	bullionise
besang	besing
befure	before
board-of-directors	board of directors
braced aback	brace aback
bosomier	bosomy
befurs	befur
boundure	bounder
birthdaying	birthday
brute-forced	brute-force
beam reaching	beam reach
biodiversifies	biodiversify
breadthening	breadthen
breedeth	breed
bindest	bind
bioneering	bioneer
biodiversified	biodiversify
bedaubs	bedaub
brute-forces	brute-force
bowdlerizing	bowdlerize
bepatted	bepat
besuiting	besuit
beheadeth	behead
builded	build
broadened	broaden
blent	blend
bodging	bodge
blacklining	blackline
byhearted	byheart
besmutting	besmut
bespeaks	bespeak
Bp.	bishop
bespeckling	bespeckle
befalleth	befall
begets	beget
bambooed	bamboo
bleedest	bleed
banalizing	banalize
bandieth	bandy
betokens	betoken
bakshishing	bakshish
bleakens	bleaken
Burmanizing	Burmanize
bedhopped	bedhop
balsams	balsam
binkied	binky
beclowning	beclown
brandest	brand
boxed the compass	box the compass
believeth	believe
buckayro	buckaroo
bottle-feeds	bottle-feed
beglamoring	beglamor
Bps	bytes per second
bemuddling	bemuddle
bids adieu	bid adieu
banqueteered	banqueteer
beheldest	behold
boils	boil
balsamed	balsam
battelled	battel
barneys	barney
baffed	baff
bogged off	bog off
back-channelled	back-channel
bedwarfing	bedwarf
bridges the gap	bridge the gap
backlinking	backlink
beclumpses	beclumpse
buggered	bugger
batiked	batik
beneficiated	beneficiate
burked	burke
bemulced	bemulce
besnows	besnow
bounceth	bounce
breddest	breed
brought forward	bring forward
betwound	betwynde
basalte	basalt
battologizes	battologize
baby-talks	baby-talk
betosses	betoss
battologized	battologize
biofragmental	biofragmentable
blithers	blither
bitters	bitter
bangtailing	bangtail
bridged the gap	bridge the gap
batters	batter
befriending	befriend
biddin'	bidding
belikes	belike
beglamored	beglamor
black-marketing	black-market
bends the rules	bend the rules
bit the dust	bite the dust
buisness	business
blennorrhœic	blennorrheic
bellied up	belly up
blunter	blunt
befilmed	befilm
byhearts	byheart
bemars	bemar
bidding	bid
binarised	binarise
balanceth	balance
bulemic	bulimic
baulkiest	baulky
bulemia	bulimia
binding over	bind over
barbacking	barback
begetting	beget
biking	bike
bepraising	bepraise
bludgeons	bludgeon
bowstringed	bowstring
bellowed	bellow
befruited	befruit
barkin'	barking
beborken	bebark
beavered away	beaver away
blackbirded	blackbird
bentricular	ventricular
Britishise	Britishize
beserker	berserker
broughtest	bring
barneying	barney
bestoweth	bestow
bellying	belly
boulsters	boulster
burn'd	burn
bolstereth	bolster
barbequing	barbeque
beares	beare
bumfuzzles	bumfuzzle
beared	bear
bumfuzzled	bumfuzzle
bunkoing	bunko
bossing about	boss about
blives	blive
bicucculine	bicuculline
beta reduced	beta reduce
botches up	botch up
babytalked	babytalk
beta reduces	beta reduce
basilectalizing	basilectalize
bats away	bat away
ballots	ballot
bliven	blive
blowest	blow
bones up	bone up
backdooring	backdoor
bemingled	bemingle
borne fruit	bear fruit
bendiest	bendy
brushing aside	brush aside
budging	budge
beplasters	beplaster
bemingles	bemingle
beats one's meat	beat one's meat
bemerding	bemerd
belabors	belabor
bemadding	bemad
becreeping	becreep
brakes	brake
bespangled	bespangle
baaed	baa
bespangles	bespangle
braked	brake
bevvied	bevvy
bruising	bruise
beknitting	beknit
bedoes	bedo
Borks	borks
bedanced	bedance
bemonstering	bemonster
broken up	break up
blessedest	blessed
bombinating	bombinate
belts out	belt out
bereaving	bereave
backs down	back down
berthed	berth
beshrouding	beshroud
bebeasting	bebeast
boringest	boring
bisecting	bisect
bge	beige
biographing	biograph
brawnier	brawny
buys time	buy time
Bremains	Bremain
betwyxt	betwixt
blow-waves	blow-wave
birches	birch
boskiest	bosky
brow-beating	brow-beat
birched	birch
blow-waved	blow-wave
behaving	behave
baed	ba
bureaucratising	bureaucratise
baitest	bait
buddy breathes	buddy breathe
begoes	bego
besieged	besiege
brynge	bring
bantering	banter
besieges	besiege
buddy breathed	buddy breathe
born upon	bear upon
branchline	branch line
boogalooing	boogaloo
bolsters	bolster
behavin'	behaving
ballaragged	ballarag
backchaining	backchain
Brit	British
bewilders	bewilder
bewrayed	bewray
bump-starting	bump-start
billoweth	billow
beprosed	beprose
breast feeding	breast feed
begun with the chucky	begin with the chucky
beproses	beprose
biteth	bite
begirdling	begirdle
brocage	brokerage
begrimed	begrime
brunching	brunch
betwattled	betwattle
beflecking	befleck
betakes	betake
betwattles	betwattle
betaken	betake
begrimes	begrime
blasting off	blast off
b/c	backward compatibility
bravade	bravado
borks	bork
blows away	blow away
backcombing	backcomb
bludgeoning	bludgeon
betreading	betread
banalization	banalisation
band-aids	band-aid
bottlenecked	bottleneck
berried	berry
bleached	bleach
banishing	banish
bleaches	bleach
bogging	bog
berries	berry
blenking	blenk
bartered	barter
bescumbered	bescumber
benumbs	benumb
barbarizing	barbarize
broken and entered	break and enter
bioturbates	bioturbate
backdropping	backdrop
banistering	banister
begged the question	beg the question
bedamping	bedamp
blocking up	block up
bobsleds	bobsled
bucked for	buck for
bingoing	bingo
blew off steam	blow off steam
bassooning	bassoon
bongoed	bongo
bullshat	bullshit
boniest	bony
bechetogenic	behcetogenic
breathes out	breathe out
boots	boot
Bizantian	Byzantine
buttfucks	buttfuck
beshitten	beshite
bobtailing	bobtail
brokered	broker
brailing	brail
Buddhized	Buddhize
brickled	brickle
biodegrading	biodegrade
brickles	brickle
bescumbering	bescumber
birdsat	birdsit
bruskest	brusk
bedding down	bed down
becoz	because
blimps	blimp
backsighted	backsight
beigest	beige
bletted	blet
bites	bite
bedimmed	bedim
bump-starts	bump-start
borne out	bear out
beaten up	beat up
brain-storms	brain-storm
body checked	body check
busking	busk
batmanning	batman
blacke-saint	black sanctus
boolean	Boolean
binarized	binarize
blusteriest	blustery
BBBJ	bareback blowjob
ballsed	balls
bollocksing	bollocks
blockades	blockade
balketh	balk
buoying up	buoy up
becomes	become
breaking it down	break it down
becomen	become
bodyjacks	bodyjack
blindsided	blindside
bepowdered	bepowder
becomed	become
botchier	botchy
botanized	botanize
breathing out	breathe out
bar mitzvahing	bar mitzvah
botanizes	botanize
broadsided	broadside
boegoe	Variant
bethwacking	bethwack
broadsides	broadside
bechalks	bechalk
brings down the hammer	bring down the hammer
bunkos	bunko
biomethylating	biomethylate
boasting	boast
bountifuller	bountiful
becharmed	becharm
brailles	braille
beshadows	beshadow
B.N.	bachelor
bedrank	bedrink
beaths	beath
backronyming	backronym
blowing off steam	blow off steam
Bhuddas	Buddhas
betitling	betitle
bone-fire	bonfire
bobbitted	bobbitt
bedagging	bedag
Banbury stories	Banbury stories of a cock and a bull
bulks up	bulk up
b****cks	bollocks
burned out	burn out
backs into	back into
burlesquing	burlesque
bigger-dicked	big-dicked
bestrewn	bestrew
budges up	budge up
bestrews	bestrew
briskest	brisk
bottoms for	bottom for
briskening	brisken
bathin'	bathing
BFG	w:Big Fucking Gun
besmooched	besmooch
BFD	big deal
bless'd	bless
blameth	blame
buttered up	butter up
BFS	breadth-first search
besmooches	besmooch
blacked up	black up
bleeded	bleed
bed-hopping	bed-hop
belocks	belock
burying the lede	bury the lede
Botoxed	Botox
befilthed	befilth
bursteth	burst
blimped out	blimp out
billowier	billowy
banqueting	banquet
blackballs	blackball
buttering up	butter up
butchest	butch
bayonetted	bayonet
beswearing	beswear
bloodletting	bloodlet
backtested	backtest
bituminating	bituminate
bentshing	bentsh
butt-raped	butt-rape
birthing	birth
bobos	bobo
browbeating	browbeat
bedeviling	bedevil
beleaving	beleave
bottlenecking	bottleneck
bastardise	bastardize
bleaching	bleach
blankening	blanken
beachcombs	beachcomb
bagelled	bagel
bepommeling	bepommel
backwashed	backwash
befriended	befriend
bucked up	buck up
bequoting	bequote
burye	bury
borries	borry
beseeks	beseek
birthin'	birthing
bakhshished	bakhshish
borried	borry
beining	bein
burking	burke
batted away	bat away
bespeakest	bespeak
bewielded	bewield
biasing	bias
blogged	blog
bears	bear
blinkered	blinker
bagses	bags
blegs	bleg
bagsed	bags
beare	bear
bids fair	bid fair
bedshares	bedshare
bitsier	bitsy
breadier	bready
bacteriotrophic	bacteriotropic
beleaping	beleap
bedshared	bedshare
beteeming	beteem
bobsledded	bobsled
building castles in the air	build castles in the air
beslaved	beslave
blewe	blue
boloed	bolo
bepearling	bepearl
bloak	bloke
bes	be
berths	berth
bechancing	bechance
borrowing	borrow
bullering	buller
based on	base on
begems	begem
bethumps	bethump
becroggled	becroggle
broad reaching	broad reach
blores	blore
bladed	blade
basilectalized	basilectalize
burgling	burgle
bachelour	bachelor
bedamns	bedamn
battles	battle
blored	blore
brittlest	brittle
bestrode	bestride
beddest	bed
begathered	begather
battled	battle
breaking the ice	break the ice
blades	blade
bachelor's	bachelor's degree
beating one's swords into ploughshares	beat one's swords into ploughshares
brutalising	brutalise
bannian	banyan
bedewed	bedew
bonusing	bonus
blacking up	black up
ballsier	ballsy
besetten	alternative past participle
belives	belive
bobars	bobar
beliven	belive
bewrays	bewray
beslavering	beslaver
bucketizing	bucketize
based	base
brings forth	bring forth
buzzier	buzzy
Brexiting	Brexit
brayed	bray
brighter	bright
baser	base
bourding	bourd
breasting	breast
brown-bags	brown-bag
branked	brank
buyed	buy
BDAC	benzyldimethylhexadecylammonium chloride
beatifying	beatify
buffaloing	buffalo
blacktopping	blacktop
beleiver	believer
beleives	believes
behoving	behove
beleived	believed
beggarliest	beggarly
bepowdering	bepowder
buggering up	bugger up
beggaring	beggar
bedevilled	bedevil
befanged	befang
betrims	betrim
beading	bead
basening	basen
brachydactily	brachydactyly
Batmans	Batman
blackleading	blacklead
bouted	bout
burning the midnight oil	burn the midnight oil
barreling	barrel
buryin'	burying
buckets	bucket
besplashed	besplash
blinked	blink
bucketing down	bucket down
brimmeth	brim
besplashes	besplash
Border Collie	border collie
broken out	break out
bewailest	bewail
betaking	betake
budged up	budge up
becrawling	becrawl
blacksplaining	blacksplain
becrossing	becross
bespawls	bespawl
belibelling	belibel
blackboarded	blackboard
betees	betee
brunting	brunt
betrayed	betray
beshrews	beshrew
bloodied up	bloody up
blouding	bloud
bricked	brick
brennschluss	Brennschluss
bobbared	bobbar
beslabbering	beslabber
bewhored	bewhore
barming	barm
binning	bin
bewhores	bewhore
bewatering	bewater
bicommisural	bicommissural
beglues	beglue
boogers up	booger up
barkiest	barky
blimps out	blimp out
beglued	beglue
bayoneting	bayonet
bead-breaker	bead breaker
bemeaned	bemean
bred in the bone	breed in the bone
Barnumised	Barnumise
baggiest	baggy
begynnynge	beginning
bucks	buck
blisses out	bliss out
bestilled	bestill
Barnumises	Barnumise
began	begin
bump-started	bump-start
begat	beget
blendest	blend
backsteps	backstep
bootstrapping	bootstrap
blazening	blazen
blithens	blithen
backtraced	backtrace
ballatry	balladry
beduking	beduke
ballsed around	balls around
bringing to bear	bring to bear
bedears	bedear
BF	booking fee
bosonizing	bosonize
BA	bad-ass
BB	bulletin board
BC	backward compatibility
BM	Bahasa Malaysia
BO	body odor
BI	business intelligence
BT	bench trial
BU	broken up
BV	backing vocals
BW	bench warrant
BP	bipolar
BR	business route
BS	bullshit
brainstorms	brainstorm
brairded	braird
Bd	board
bacsheese	baksheesh
Bn	benzyl
burninates	burninate
Bu	butyl
bioconverting	bioconvert
balloons	balloon
Bz	benzoyl
bemauling	bemaul
bends the truth	bend the truth
brairding	braird
broughten	bring
balance-beam	balance beam
bottoms	bottom
B.	baron
B4	before
beguyling	beguyle
bigs up	big up
back-channelling	back-channel
blindeth	blind
braggles	braggle
belonged	belong
bemuffling	bemuffle
brazing	braze
boggled	boggle
burnest	burn
body checking	body check
boggles	boggle
BDE	big dick energy
BDD	business-driven development
BDC	bullet drop compensation
bodybuilt	bodybuild
BDU	battle dress uniform
barred out	bar out
bollocksing up	bollocks up
blythe	blithe
banged away	bang away
blown one's load	blow one's load
berimes	berime
benumbed	benumb
bituminizing	bituminize
berimed	berime
bebars	bebar
battalioned	battalion
bediapers	bediaper
belongest	belong
blamin'	blaming
bepowers	bepower
bravadoed	bravado
bonafied	bona fide
buying up	buy up
brushed aside	brush aside
bodyboarded	bodyboard
bulldozered	bulldozer
bolused	bolus
businesspeople	businessperson
budgeted	budget
befell	befall
bestriding	bestride
breaststrokes	breaststroke
beats	beat
baaad	bad
breaststroked	breaststroke
biya	beer
beefing up	beef up
backslashing	backslash
baby-sitting	baby-sit
benzamindine	benzamidine
batooned	batoon
blunders	blunder
besmutches	besmutch
built castles in the air	build castles in the air
BASE jumps	BASE jump
besmutched	besmutch
bronchi	bronchus
ball-busted	ball-bust
blogs	blog
brushing up	brush up
bureaucratizes	bureaucratize
bum-rushing	bum-rush
badmouths	badmouth
bonzidine	benzidine
bossier	bossy
blossomiest	blossomy
bessemerizing	bessemerize
billhooking	billhook
becrowning	becrown
B2G	business-to-government
B2C	business-to-customer
bestowing	bestow
bakin'	baking
bedusts	bedust
blacking	black
bayt	bait
broadsealed	broadseal
bulkier	bulky
belettering	beletter
broke the bank	break the bank
beering	beer
bebopped	bebop
betters	better
bemadamed	bemadam
baking	bake
blatters	blatter
begifted	begift
booting out	boot out
Birminghamized	Birminghamize
blunged	blunge
Birminghamizes	Birminghamize
burnisht	burnish
bade fair	bid fair
booteth	boot
bedarkened	bedarken
bluffest	bluff
bayed	bay
borders on	border on
bearhugged	bearhug
backcasts	backcast
bulgiest	bulgy
baricenter	barycenter
bemercies	bemercy
baskt	bask
basks	bask
bagpiping	bagpipe
bemercied	bemercy
becharming	becharm
bore down	bear down
bescattered	bescatter
beflaying	beflay
belaving	belave
Baidus	Baidu
bumbazed	bumbaze
blarsted	blasted
buckled	buckle
bosses around	boss around
begroans	begroan
buckles	buckle
baiteth	bait
bumbazes	bumbaze
blown the whistle	blow the whistle
bucking for	buck for
bussed	buss
benter	bent
biophosphonate	bisphosphonate
brumates	brumate
busses	buss
brumated	brumate
begowking	begowk
barks	bark
buggering	bugger
backing out	back out
brevetted	brevet
barke	bark
bitched out	bitch out
born in with	bear in with
becuts	becut
bepuffed	bepuff
betalks	betalk
befeathered	befeather
bodychecking	bodycheck
berascalled	berascal
betiding	betide
buggerin'	buggering
backpropagates	backpropagate
bush-dog	bush dog
backpropagated	backpropagate
barbers	barber
blips	blip
burning out	burn out
bewitch'd	bewitch
babbiting	babbit
brest	breast
besorted	besort
breaking the bank	break the bank
belying	belie
braids	braid
badging	badge
buys a dog and barks oneself	buy a dog and bark oneself
buyeth	buy
bifunctionalized	bifunctionalize
blanks	blank
blanker	blank
bulletproofing	bulletproof
bifunctionalizes	bifunctionalize
besits	besit
blated	blate
blacksplains	blacksplain
bairnliest	bairnly
balaunce	balance
bebanged	bebang
blurting out	blurt out
blocks up	block up
buttin'	butting
brought to bear	bring to bear
bucolingually	buccolingually
ballsing up	balls up
befals	befal
buckle cavity	malapropism
banged	bang
backtagging	backtag
budding	bud
bumps uglies	bump uglies
baiting	bait
betted	bet
begge	beg
beclept	beclepe
blackened	blacken
beshaming	beshame
birled	birl
beneficiating	beneficiate
blondest	blonde
backstreaming	backstream
blithening	blithen
bootay	booty
Beduin	bedouin
bishoping	bishop
blacklegged	blackleg
booping	boop
backed out	back out
borrowest	borrow
brilliantines	brilliantine
bonsais	bonsai
bolixes	bolix
bespake	bespeak
begane	begin
bolixed	bolix
bayliff	bailiff
brilliantined	brilliantine
bluntest	blunt
browniest	browny
buying off on	buy off on
blow-dries	blow-dry
bldg	building
blindened	blinden
backquoted	backquote
backlit	backlight
bepowering	bepower
bloodshotten	bloodshot
blow-dried	blow-dry
burblier	burbly
bulwarked	bulwark
bandies about	bandy about
benefitest	benefit
benefitteth	benefit
broken one off	break one off
bescatters	bescatter
begging to differ	beg to differ
beeriest	beery
bought the farm	buy the farm
bouncin'	bouncing
BLASTs	BLAST
bobbitised	bobbitise
bescreened	bescreen
bewizarding	bewizard
bails out	bail out
beshielding	beshield
boardin'	boarding
ballyhooed	ballyhoo
bodye	body
balloted	ballot
bleeding out	bleed out
boating	boat
barneyed	barney
bedell	beadle
blackboxing	blackbox
Bowdlerizing	Bowdlerize
bepommels	bepommel
BBN	bulletin board network
bebork	bebark
broils	broil
betokening	betoken
BBB	blood-brain barrier
bestills	bestill
becraving	becrave
BBW	big bad wolf
breaks it down	break it down
BBS	bulletin board system or bulletin board service
begins	begin
broadenest	broaden
backtrails	backtrail
bidded	bid
bechilling	bechill
bedecked	bedeck
braais	braai
bears fruit	bear fruit
brominated	brominate
bounces	bounce
bandied around	bandy around
brominates	brominate
bewailed	bewail
bedusted	bedust
busks	busk
besews	besew
backtagged	backtag
bastinades	bastinade
buggier	buggy
bawded	bawd
bastinaded	bastinade
bittering	bitter
bewares	beware
blahdy	bloody
brakest	break
begs the question	beg the question
breathed	breathe
bitten in	bite in
bolking	bolk
beamier	beamy
bloodens	blooden
bronzifies	bronzify
bedrabbled	bedrabble
bronzified	bronzify
bad-faith	bad faith
birdsitting	birdsit
blew down	blow down
bob wire	barbed wire
bechalked	bechalk
blossometh	blossom
briefer	brief
behung	behang
bellyflopping	bellyflop
bedecketh	bedeck
breast-fed	breast-feed
briefed	brief
battologizing	battologize
bam	bare-arse minimum
bak	back
bitsiest	bitsy
Bg.	Bulgarian
bamboshing	bambosh
BTFO	blow out
burgeoneth	burgeon
burns the midnight oil	burn the midnight oil
beknaves	beknave
bedoing	bedo
beknaved	beknave
bioneutralized	bioneutralize
blitzes	blitz
blitzed	blitz
burping	burp
bevoices	bevoice
bruize	bruise
bevoiced	bevoice
brushed one's teeth	brush one's teeth
bronzer	bronze
bowdacious	bodacious
burthen	burden
ballparks	ballpark
belked	belk
backprinting	backprint
bought it	buy it
backpeddled	backpeddle
bentest	bend
beleiving	believing
backpeddles	backpeddle
bedims	bedim
besnewing	besnew
beclarting	beclart
briefs	brief
boofing	boof
bereaveth	bereave
bejanked	bejank
bobbittize	Bobbittize
berylium	beryllium
bouncing off the walls	bounce off the walls
branniest	branny
babyfying	babyfy
barricadoing	barricado
back-handed	back-hand
buskling	buskle
breatheth	breathe
bepearls	bepearl
beshades	beshade
bale out	bail out
bunked	bunk
blew up	blow up
bottles	bottle
berming	berm
billeted	billet
bottled	bottle
breadcrumbing	breadcrumb
bells	bell
beseeking	beseek
bearded	beard
bleeding like a stuck pig	bleed like a stuck pig
bedogged	bedog
beaching	beach
blowziest	blowzy
begripping	begrip
bioaugmented	bioaugment
briding	bride
baciloscopy	bacilloscopy
blindering	blinder
bites the biscuit	bite the biscuit
bull-dyke	bull dyke
best-hung	well-hung
Bitcoin	bitcoin
bedizened	bedizen
bolled	boll
broodest	brood
beglorying	beglory
b'lieve	believe
borrying	borry
boinked	boink
becloaking	becloak
bantered	banter
borne in with	bear in with
borged	borg
biffed	biff
becamest	become
baruch HaShem	baruch Hashem
breaks water	break water
boasted	boast
biiig	big
blanching	blanch
beholde	behold
bringing forth	bring forth
bankette	banquet
bleachest	bleach
Bos.	Boston
bled dry	bleed dry
boinks	boink
bets	bet
befruiting	befruit
beggest	beg
bedribbling	bedribble
bedevils	bedevil
blinds with science	blind with science
bookcrosses	bookcross
bets up	bet up
babyfies	babyfy
bookcrossed	bookcross
bolning	boln
butterflying	butterfly
bedewing	bedew
brecciated	brecciate
breedes	breede
betting up	bet up
bedraping	bedrape
befreed	befree
bikesheds	bikeshed
bequivers	bequiver
boord	board
burling	burl
bookstaves	Alternative plural
befrees	befree
beseeing	besee
birdied	birdie
bumbazing	bumbaze
Britishifies	Britishify
bewondered	bewonder
beslavers	beslaver
badmouthed	badmouth
birdies	birdie
boogied	boogie
bandied about	bandy about
binding on equip	bind on equip
besplashing	besplash
boogies	boogie
buffed	buff
bepuffing	bepuff
beglooming	begloom
belabours	belabour
bombs around	bomb around
balloonneer	ballooner
B. Litt.	Bachelor of Letters
barrelling	barrel
bestraddles	bestraddle
bouncing back	bounce back
brachycephalism	brachycephaly
button mashing	button mash
bevels	bevel
bestraddled	bestraddle
builds	build
backcasted	backcast
behedged	behedge
Btb.	bass tuba
bounde	bound
bruxed	brux
bleating	bleat
busying	busy
bruxes	brux
black-bagged	black-bag
blowing up	blow up
besoughtest	beseech
bretticed	brettice
blopping	blop
BCVA	Best Corrected Visual Acuity
backhoeing	backhoe
brightens	brighten
budded	bud
bebops	bebop
babysitting	babysit
boldly went where no man has gone before	boldly go where no man has gone before
backporting	backport
blushing	blush
boondoggled	boondoggle
bravoing	bravo
befalen	befal
brairds	braird
busie	busy
broke with	break with
bombed	bomb
buying it	buy it
bobaring	bobar
breaking even	break even
blows over	blow over
blithest	blithe
bordered	border
boundest	bind
begifts	begift
ballooning	balloon
blazoned	blazon
buccaneering	buccaneer
bromizes	bromize
bearing fruit	bear fruit
beg parding	beg pardon
bogeyed	bogey
baffing	baff
belting up	belt up
bedances	bedance
banished	banish
brattier	bratty
bitches out	bitch out
byrling	byrl
banishes	banish
bovinizing	bovinize
barracked	barrack
battlin'	battling
buncha	bunch of
bumming around	bum around
boobied	booby
butylates	butylate
butylated	butylate
brushed by	brush by
bodying	body
bewdy	beauty
barricado'd	barricadoed
bruises	bruise
back-translated	back-translate
biopsied	biopsy
bellycrawled	bellycrawl
breadiest	bready
bitbuckets	bitbucket
biopsies	biopsy
back-translates	back-translate
bruised	bruise
bloodying	bloody
bunchier	bunchy
bleeding like a stuck hog	bleed like a stuck hog
bedecking	bedeck
besotting	besot
bucanier	buccaneer
bears upon	bear upon
barley-sugar	barley sugar
buying off	buy off
bouting	bout
burieth	bury
backchained	backchain
biographed	biograph
bazar	bazaar
balks	balk
backlogging	backlog
breathes in	breathe in
binnered	binner
bioerodes	bioerode
Braz	Brazilian
burglarises	burglarise
bioeroded	bioerode
burglarised	burglarise
brutifies	brutify
beefsteak	beefsteak mushroom
bited	bite
bossiest	bossy
B.Comm.	bachelor
BeV	billion electron volt
backlinked	backlink
broke it down	break it down
borne up	bear up
boggery	buggery
binarizes	binarize
battered	batter
besouls	besoul
backsolving	backsolve
burgeoning	burgeon
begrasps	begrasp
brashier	brashy
Botoxes	Botox
borrowin'	borrowing
bracketing	bracket
backtracked	backtrack
bicondilar	bicondylar
breaks in	break in
buddled	buddle
brought low	bring low
buddles	buddle
basked	bask
bestialising	bestialise
basidospore	basidiospore
beslaves	beslave
boulevardiered	boulevardier
blooded	blood
BNA	British North America
Balkanizing	Balkanize
bucketized	bucketize
brained	brain
bar exam	bar examination
blackboxed	blackbox
bucketizes	bucketize
bluesiest	bluesy
bunchiest	bunchy
brutifying	brutify
buggers off	bugger off
bedecks	bedeck
baddened	badden
bulliragged	bullirag
bivvied	bivvy
blackfished	blackfish
break down	breakdown
brews	brew
boohoos	boohoo
beaten around the bush	beat around the bush
BLBT	boneless lean beef trimmings
begrasping	begrasp
babysits	babysit
breaks wind	break wind
becalled	becall
beclosing	beclose
bench bleeding	bench bleed
blubbed	blub
bradding	brad
beclowns	beclown
backburnered	backburner
brimming	brim
beblotting	beblot
bawding	bawd
bootlegged	bootleg
brooks	brook
bestrewed	bestrew
brooke	broke
burdenest	burden
bebathing	bebathe
bore witness	bear witness
brisker	brisk
believing in	believe in
befor	before
bottle-fed	bottle-feed
baggier	baggy
betided	betide
barocycling	barocycle
busheled	bushel
bebothering	bebother
bemoils	bemoil
babytalking	babytalk
buists	buist
Black	black
bethatching	bethatch
bricking up	brick up
backburnering	backburner
broachest	broach
biotreated	biotreat
bawwing	baww
bewared	beware
buts	but
beelining	beeline
bethroth	betroth
bobs	bob
benumbeth	benumb
brancht	branch
burbolt	birdbolt
batiks	batik
browning	brown
booted	boot
bedarkens	bedarken
bringing down	bring down
browserified	browserify
bar mitzvahed	bar mitzvah
bentivorous	benthivorous
browserifies	browserify
briefe	brief
bet.	between
bailed	bail
beshone	beshine
bleatin'	bleating
BitCoin	bitcoin
bestreaked	bestreak
braideth	braid
balbutiating	balbutiate
blindens	blinden
blackest	black
beta	beta male
bete	beat
bedropping	bedrop
befouled	befoul
blahing	blah
belly flopping	belly flop
blooping	bloop
badley	badly
bepinched	bepinch
brawned	brawn
bepinches	bepinch
beaned	bean
badgered	badger
balbucinates	balbucinate
bringed	bring
bonks	bonk
brogs	brog
backlogged	backlog
balbucinated	balbucinate
becheckered	bechecker
bicinchroninic	bicinchoninic
bituminising	bituminise
braveliest	bravely
besprinkling	besprinkle
beckonest	beckon
BNC	bouncer
bayze	baize
breezened	breezen
blends	blend
biosynthesized	biosynthesize
blippiest	blippy
busiest	busy
besighing	besigh
biosynthesizes	biosynthesize
broggling	broggle
bites in	bite in
bluening	bluen
beginning with the chucky	begin with the chucky
blurred	blur
brings to bear	bring to bear
brings upon	bring upon
bepitying	bepity
bowssens	bowssen
bldg.	building
beaking	beak
broasts	broast
bedraggles	bedraggle
brooching	brooch
bewrote	bewrite
beleaps	beleap
beleapt	beleap
blew the whistle	blow the whistle
becrippling	becripple
bedraggled	bedraggle
bopping	bop
bracheocephalic	brachiocephalic
baubling	bawbling
blasts	blast
beats up	beat up
belanded	beland
breakfasts	breakfast
badest	baddest
blennorrhœa	blennorrhea
beautyful	beautiful
barebacks	bareback
binating	binate
bioanalyzed	bioanalyze
borders	border
badmouthing	badmouth
bayesian	Bayesian
bestands	bestand
bowning	bowne
butterier	buttery
bumpfiring	bumpfire
benames	bename
buttons up	button up
bromizing	bromize
blearier	bleary
belocked	belock
blackballed	blackball
bant	banter
baling out	bale out
bubbles up	bubble up
blabbered	blabber
blindfolding	blindfold
bubbles over	bubble over
baths	bath
banquetting	banquet
beene	been
backstabbing	backstab
bolshevized	bolshevize
blennorrhœæ	blennorrhœa
bromodeoxiuridine	bromodeoxyuridine
bolshevizes	bolshevize
boughtest	buy
bumpin'	bumping
blarneys	blarney
bittered	bitter
bitten the dust	bite the dust
brass-band	brass band
boganning	bogan
bears witness	bear witness
bitterer	bitter
bedrenching	bedrench
bowsed	bowse
buirdliest	buirdly
biggered	bigger
ballsiest	ballsy
blue-balling	blue-ball
belittlest	belittle
bowses	bowse
bitchslaps	bitchslap
bumping	bump
bravens	braven
bludges	bludge
bludged	bludge
bloque	block
bums around	bum around
becrept	becreep
blissoms	blissom
backround	background
badmitten	badminton
bemoiling	bemoil
bombed around	bomb around
boids	birds
buddling	buddle
black-box	black box
bipartitioned	bipartition
bronchorrhœa	bronchorrhoea
blankets	blanket
bestanding	bestand
boomslange	boomslang
black boxed	black box
bombasting	bombast
black boxes	black box
backspinning	backspin
bewitched	bewitch
beefed up	beef up
BASE jumped	BASE jump
belts up	belt up
bobsleighing	bobsleigh
booming	boom
boomeranging	boomerang
beleagured	beleagure
backstopped	backstop
bemauled	bemaul
berberin	berberine
beleagures	beleagure
bedrugs	bedrug
beavering away	beaver away
brokes	broke
broken	break
bicinchonic	bicinchoninic
bloats	bloat
buttresses	buttress
broked	broke
belieth	belie
brancheth	branch
brainier	brainy
bedreamed	bedream
bedunging	bedung
blessed	bless
belted out	belt out
burandanga	burundanga
blesses	bless
bebanging	bebang
behandling	behandle
berhymes	berhyme
better for you	good for you
belly of the whale	Belly of the Whale
blacke santus	black sanctus
blue lighted	blue light
bummled	bummle
batspit	batshit
belates	belate
baselining	baseline
bent the truth	bend the truth
belated	belate
borylates	borylate
becloaked	becloak
brown-nosing	brown-nose
bereads	beread
billowed	billow
basificates	basificate
branchiest	branchy
borylated	borylate
basificated	basificate
brassened	brassen
bedrenches	bedrench
befleaed	beflea
banhammers	banhammer
blackguarded	blackguard
backspacing	backspace
bedrenched	bedrench
befrosting	befrost
balbutiated	balbutiate
binocular	binoculars
braggiest	braggy
bandying about	bandy about
bragging	brag
bigfooting	bigfoot
bushelled	bushel
behappens	behappen
bullyragged	bullyrag
backscattered	backscatter
becalms	becalm
bleeds dry	bleed dry
brands	brand
BRAT	bananas, rice, apple sauce, toast
brooming	broom
blabbier	blabby
burrow	borough
babbits	babbit
blackholed	blackhole
bottoming	bottom
burdening	burden
beshields	beshield
behooved	behoove
bravest	brave
blood brethren	blood brother
bacterizing	bacterize
behooves	behoove
buttfucking	buttfuck
bestranging	bestrange
belibels	belibel
bedinnered	bedinner
Bardolator	bardolator
bewaters	bewater
benamed	bename
blinding with science	blind with science
basifies	basify
bitiest	bitey
bebreaking	bebreak
bypasses	bypass
Betamaxing	Betamax
blares	blare
beehiving	beehive
baseth	base
bobbling	bobble
bankrolled	bankroll
bypassed	bypass
begodding	begod
becometh	become
bespattered	bespatter
bootjacks	bootjack
beams up	beam up
backs off	back off
belly-dance	belly dance
Brig. Gen.	brigadier general
bespirts	bespirt
brackets	bracket
backtracing	backtrace
brattiest	bratty
beflies	befly
buycotted	buycott
bushwhacked	bushwhack
blattering	blatter
BLS	basic life support
BLR	broad-line region
bleezing	bleeze
blubs	blub
bestirs	bestir
B.M.E.	bachelor
besworn	beswear
bobsledding	bobsled
beswore	beswear
better-informed	well-informed
bycause	because
Britisher	British
beasting	beast
bird-dogging	bird-dog
buses	bus
building up	build up
bused	bus
besainted	besaint
bescattering	bescatter
buys out	buy out
barked	bark
biocodes	biocode
bore fruit	bear fruit
ballistae	ballista
biocoded	biocode
bullwhipped	bullwhip
barrel racing	barrel race
bebreaks	bebreak
binates	binate
bursting into tears	burst into tears
bretheren	brethren
bikeshedding	bikeshed
breaking-and-entering	breaking and entering
backspun	backspin
bodged	bodge
belapping	belap
BATNEEC	best available techniques not entailing excessive costs
bogged down	bog down
basketed	basket
babyfied	babyfy
barber-shop	barber shop
blusterier	blustery
Borgs	Borg
barbequed	barbeque
bk.	book
bonzerest	bonzer
biting down	bite down
biographizing	biographize
birthday-girl	birthday girl
back-bitten	back-bite
blacked	black
besparkles	besparkle
baulking	baulk
bemadded	bemad
bedrawing	bedraw
berobbing	berob
bites the dust	bite the dust
bitchiest	bitchy
blacker	black
besparkled	besparkle
bullionising	bullionise
bemulcing	bemulce
bedizzened	bedizzen
bloating	bloat
BMWW	black man, white woman
bulking out	bulk out
bathes	bathe
bichromatizes	bichromatize
bipolarized	bipolarize
bungaroxin	bungarotoxin
bound on pickup	bind on pickup
boogying down	boogie down
bagsies	bagsy
beguilted	beguilt
baaa	baa
blows down	blow down
bereft	bereave
beclepes	beclepe
blizzarded	blizzard
boldfacing	boldface
bluewashes	bluewash
bandages	bandage
beworried	beworry
backcalculated	backcalculate
bluewashed	bluewash
bestirred	bestir
bookended	bookend
baby-talking	baby-talk
bownes	bowne
blissomed	blissom
bowned	bowne
bastile	bastille
bedizzens	bedizzen
bankrupted	bankrupt
bladdering	bladder
beds down	bed down
bamboozleable	bamboozlable
beginnin'	beginning
bowdlerized	bowdlerize
beardier	beardy
bowdlerizes	bowdlerize
bandolining	bandoline
benims	benim
bowks	bowk
buyou	bayou
berrying	berry
bleedin' obvious	bleeding obvious
balladeered	balladeer
bejumbles	bejumble
bonifying	bonify
backstreams	backstream
brings low	bring low
barkest	bark
beginning	begin
beleue	believe
bragged	brag
benefits	benefit
beavers away	beaver away
blossoming	blossom
bragger	brag
binarizing	binarize
brawlier	brawly
banditing	bandit
beyant	beyond
bedirtying	bedirty
bullier	bully
bullies	bully
bolshier	bolshie
bullied	bully
bloodied	bloody
bloodier	bloody
bloodies	bloody
benewed	benew
broke out	break out
bluntens	blunten
blicked	blick
blusterest	bluster
backchannelling	backchannel
bunted	bunt
backshishing	backshish
boofiest	boofy
belain	belie
blatting	blat
borderlined	borderline
builders'	builders' tea
bitch slapped	bitch slap
bedaws	bedaw
beloaded	beload
bourgeon	burgeon
beknew	beknow
bragging on	brag on
bewizards	bewizard
bevers	bever
built	build
bankrolls	bankroll
bedumbed	bedumb
bemouthed	bemouth
biotreating	biotreat
bawws	baww
Borging	Borg
blue-pencilling	blue-pencil
besmearing	besmear
booked it	book it
begluing	beglue
beshadowed	beshadow
bullionizes	bullionize
bedashing	bedash
brainwiping	brainwipe
bullionized	bullionize
blikening	bliken
blusht	blush
beshrewed	beshrew
biotesting	biotest
buffooning	buffoon
bearing in mind	bear in mind
beclouting	beclout
bespeaking	bespeak
backtracking	backtrack
banish'd	banish
brushed	brush
bescumbers	bescumber
BOP	Bureau of Prisons
best for you	good for you
beluting	belute
BOQ	bachelors' officers' quarters
birdnested	birdnest
batted	bat
backstops	backstop
basepairing	basepair
backs up	back up
bulliest	bully
blogging	blog
bepainting	bepaint
bulletproofs	bulletproof
blightest	blight
backhoed	backhoe
begathering	begather
befeathering	befeather
beautified	beautify
begave	begive
BASE jumping	BASE jump
beautifies	beautify
blowiest	blowy
BBQing	BBQ
beswears	beswear
behatting	behat
bookiest	booky
berghing	bergh
blurbing	blurb
bewending	bewend
brushes down	brush down
burned	burn
bellies	belly
brandies	brandy
betrod	betread
backgammons	backgammon
betaught	beteach
benzaminidine	benzamidine
blonder	blonde
besoothed	besoothe
back-bites	back-bite
blubbing	blub
brute-forcing	brute-force
broadseals	broadseal
brandied	brandy
bioprogramme	bioprogram
besoothes	besoothe
brunches	brunch
brushing by	brush by
bioimmuring	bioimmure
boulevardiering	boulevardier
breamed	bream
belanding	beland
backwinding	backwind
barrelled	barrel
borelap	burlap
brunched	brunch
breaking the fourth wall	break the fourth wall
bricking	brick
bongs	bong
ballyrags	ballyrag
bilatarian	bilaterian
begallowing	begallow
broach'd	broach
banes	bane
blurting	blurt
bewitchest	bewitch
bendeth	bend
bestrides	bestride
bebarking	bebark
bedwarfed	bedwarf
bovrilizing	bovrilize
broken the bank	break the bank
BJD	balljoint
blew a fuse	blow a fuse
bisnings	beestings
bebayed	bebay
bequivering	bequiver
BJJ	Brazilian jiu-jitsu
butters up	butter up
barnumizing	barnumize
BJT	bipolar junction transistor
brought up	bring up
borraginaceous	boraginaceous
bd.	boulevard
backreacted	backreact
balbucinating	balbucinate
backuped	backed up
bejuggles	bejuggle
barothropic	barotropic
brobbed	brob
began with the chucky	begin with the chucky
boobing	boob
biting in	bite in
bloomier	bloomy
brutalised	brutalise
breastfed	breastfeed
bulletining	bulletin
becurls	becurl
breathalyzed	breathalyze
backsetting	backset
buckdanceed	buckdance
bluntened	blunten
breathalyzes	breathalyze
bet-exchange	bet exchange
bookplated	bookplate
Bedlington Terrier	Bedlington terrier
brow-beats	brow-beat
bubblier	bubbly
buried the hatchet	bury the hatchet
blissoming	blissom
blueberrying	blueberry
backtrailing	backtrail
birdnapping	birdnap
Boswellized	Boswellize
bubbling over	bubble over
befouleth	befoul
bringing back	bring back
bluffing out	bluff out
Boswellizes	Boswellize
banalest	banal
bioconverts	bioconvert
bats in	bat in
blastacidin	blasticidin
BZP	benzylpiperazine
buying time	buy time
bio	Abbreviation
burstier	bursty
bewitches	bewitch
beflowers	beflower
broiders	broider
bowled out	bowl out
broke even	break even
beyng	being
buclicine	buclizine
bribing	bribe
borrowe	borrow
bulked	bulk
battens down the hatches	batten down the hatches
borrows	borrow
begriming	begrime
bacc	baccalaureate
bedamped	bedamp
bodysurfing	bodysurf
broadsiding	broadside
backlighting	backlight
brens	bren
brent	burnt
burgeoned	burgeon
beflays	beflay
boastest	boast
bequethen	bequeath
Bar.	baritone horn
barniest	barny
biofluoresces	biofluoresce
bronchodilating	bronchodilate
billetted	billet
biofluoresced	biofluoresce
bedriving	bedrive
bepuzzled	bepuzzle
blockaded	blockade
bouled	boule
briniest	briny
befrills	befrill
belting	belt
bepuzzles	bepuzzle
beans	bean
behaviouristic	behavioristic
bish	bishop
blickens	blicken
basting	baste
bucklering	buckler
bedraggling	bedraggle
befoamed	befoam
bourgeoised	bourgeois
Bauplan	bauplan
bourgeoises	bourgeois
brighteneth	brighten
balanced the books	balance the books
ballses	balls
bores	bore
blaking	blake
Borking	borking
better-behaved	well-behaved
blackfishing	blackfish
boree	bourrée
bored	bore
beam reaches	beam reach
bioeroding	bioerode
burnisheth	burnish
beam reached	beam reach
boyz	boys
boogies down	boogie down
bedaggles	bedaggle
begores	begore
braceth	brace
begored	begore
bedaggled	bedaggle
beckoning	beckon
besaints	besaint
byshop	bishop
ballasts	ballast
bepeppered	bepepper
beloads	beload
buying a dog and barking oneself	buy a dog and bark oneself
brushing	brush
berthing	berth
bolshevises	bolshevise
boppiest	boppy
brushed down	brush down
bulwarks	bulwark
bolshevised	bolshevise
bestranged	bestrange
blinks	blink
blinkt	blink
beshouts	beshout
bestranges	bestrange
befogs	befog
brogueing	brogue
bedabbles	bedabble
bespat	bespit
bedrinking	bedrink
benightened	benighten
butchier	butchy
bields	bield
breached	breach
broacheth	broach
blacke santis	black sanctus
blameshifts	blameshift
breaches	breach
brooms	broom
bottomed	bottom
beblessing	bebless
bites down	bite down
banqueteering	banqueteer
bobtailed	bobtail
Bœotarch	Boeotarch
boy's club	boys' club
bottoming the house	bottom the house
blacktopped	blacktop
busied	busy
burlesqued	burlesque
bluffed out	bluff out
befurbelowing	befurbelow
busier	busy
busies	busy
bathophenantroline	bathophenanthroline
bekenning	beken
boyling	boyle
bleeding	bleed
blobbiest	blobby
barnier	barny
buttressed	buttress
bootblacked	bootblack
blamestorms	blamestorm
blatted	blat
beiger	beige
beblessed	bebless
bedimming	bedim
beblesses	bebless
bescrawls	bescrawl
burenorphine	buprenorphine
bleedin'	bleeding
brown-bagging	brown-bag
beasts	beast
baring	bare
backstroking	backstroke
bearded-mussel	bearded mussel
betwene	between
beplastered	beplaster
bitten off	bite off
bluntening	blunten
bzzing	bzz
birdliming	birdlime
bunging	bung
ballyhooing	ballyhoo
broken bad	break bad
bipolarizes	bipolarize
bumming	bum
breveting	brevet
belands	beland
baskets	basket
by'm-by	by-and-by
basketh	bask
bovver	bother
bevomits	bevomit
belittling	belittle
bemadaming	bemadam
bornin	born
beefed	beef
butled	butle
bedeafened	bedeafen
bester	best
butles	butle
brannier	branny
batting out	bat out
bivouack	bivouac
botanised	botanise
behapped	behap
bindeth	bind
billed	bill
better-grounded	well-grounded
bebleeds	bebleed
blabs	blab
browden	braid
boned	bone
banefulest	baneful
bevelled	bevel
bedamning	bedamn
bones	bone
blowbanged	blowbang
beechier	beechy
befoaming	befoam
bucketed down	bucket down
belibelled	belibel
beats as one	beat as one
beastifies	beastify
benar	bene
benat	bene
boodying	boody
beastified	beastify
begirdles	begirdle
berisped	berisp
bit in	bite in
BHK	bedroom(s), hall, and kitchen
binn	bin
BHO	browser helper object
BHA	butylated hydroxyanisole
BHB	blue horizontal branch
beamiest	beamy
briguing	brigue
backbit	backbite
briskened	brisken
borohydrate	borohydride
blew a gasket	blow a gasket
bins	bin
boldened	bolden
bureaucratised	bureaucratise
beagles	beagle
bivoltin	bivoltine
bureaucratises	bureaucratise
benchmarks	benchmark
blackwashing	blackwash
bridges	bridge
beleive	believe
bid one's time	bide one's time
banaler	banal
backcrossed	backcross
blazin'	blazing
beacons	beacon
bridged	bridge
brigading	brigade
backcrosses	backcross
blackmarks	blackmark
bolder	bold
bestole	besteal
bolded	bold
bespeeches	bespeech
boy craziest	boy crazy
backwatered	backwater
blindfolded	blindfold
backstreamed	backstream
blazing	blaze
bloring	blore
bodysurfed	bodysurf
back-burnering	back-burner
bepissing	bepiss
biofortifying	biofortify
backtabbing	backtab
behoovest	behoove
buttonholing	buttonhole
becurses	becurse
buzzled	buzzle
bepissed	bepiss
burdened	burden
being there	be there
blueprinted	blueprint
buggiest	buggy
bleakened	bleaken
bepisses	bepiss
buzzles	buzzle
becursed	becurse
blackjacking	blackjack
breasts one's cards	breast one's cards
bassier	bassy
betelling	betell
billows	billow
bumfuzzling	bumfuzzle
balmifying	balmify
bears up	bear up
barricades	barricade
bullyproofing	bullyproof
broken off	break off
bawling out	bawl out
barriers	barrier
besiegeth	besiege
bedid	bedo
ballyragged	ballyrag
battiest	batty
bleeps	bleep
bagelling	bagel
brightening up	brighten up
braces	brace
bams	bam
breaking bread	break bread
begalls	begall
bribeth	bribe
backpropagating	backpropagate
becudgelled	becudgel
bargained	bargain
bejesuited	bejesuit
benaming	bename
boohooed	boohoo
blustrous	blusterous
bedesman	beadsman
bemerds	bemerd
behearing	behear
balkier	balky
betiming	betime
BNIB	brand new in box
blorped	blorp
bristled	bristle
betteth	bet
beggared	beggar
businesse	business
blue-balls	blue-ball
bettering	better
bête noir	bête noire
betrusting	betrust
befouling	befoul
butlered	butler
builtin	builtin function
blimped	blimp
bowelling	bowel
besprenging	besprenge
bemouthing	bemouth
BUFF	big ugly fat fellow (or fucker)
bohemia	Bohemia
breaks into	break into
bitbucketed	bitbucket
bemused	bemuse
betows	betow
brandisheth	brandish
bemuses	bemuse
brobbing	brob
black-hole	black hole
brick walls	brick wall
boffed	boff
branking	brank
bracing aback	brace aback
Braminical	Brahminical
boardwalks	boardwalk
borging	borg
bethumbs	bethumb
boils over	boil over
birching	birch
beered	beer
beeth	third-person singular simple present subjunctive
buniak	alternative form
backed off	back off
bougiest	bougie
bluesier	bluesy
b'low	below
brings off	bring off
Béchamel sauce	béchamel sauce
becringing	becringe
beseche	beseech
buying	buy
bebled	bebleed
bluescreening	bluescreen
bicause	because
bespeeched	bespeech
bottomed for	bottom for
beblew	beblow
belams	belam
bowwowed	bowwow
bedaubeth	bedaub
bit bucketing	bit bucket
bluens	bluen
bescares	bescare
befoes	befoe
bottoming for	bottom for
baby-oil	baby oil
breadboarded	breadboard
birdnaps	birdnap
brownifies	brownify
blats	blat
beaconing	gerund
befitteth	befit
boosts	boost
breaking into	break into
betrayedst	betray
bedyde	bedyed
brung	bring
blandifying	blandify
blinded with science	blind with science
breaking loose	break loose
ballsed up	balls up
burnishing	burnish
bumping off	bump off
blithened	blithen
bewhispers	bewhisper
beguiles	beguile
beguiled	beguile
blissened	blissen
blue-balled	blue-ball
bangingest	banging
basing	base
bourded	bourd
beskirts	beskirt
begging the question	beg the question
beblubbering	beblubber
beguilting	beguilt
balefulest	baleful
baroquest	baroque
befingering	befinger
bench bleeded	bench bleed
backtracks	backtrack
begroaning	begroan
believed in	believe in
ballses about	balls about
Britishifying	Britishify
burped	burp
Boswellizing	Boswellize
behaveth	behave
burred	burr
bombards	bombard
backslapping	backslap
betterfying	betterfy
BFA	w:Bachelor of Fine Arts
berates	berate
blacksmithing	blacksmith
blabbiest	blabby
back-handing	back-hand
becalling	becall
bellowest	bellow
BFF	best friend forever
begining	beginning
body checks	body check
beastifying	beastify
bemangled	bemangle
boweth	bow
brightened	brighten
behighting	behight
blacklegs	blackleg
being a thing	be a thing
blooms	bloom
BFH	big fucking hammer
betossing	betoss
buttonholed	buttonhole
blove	blive
bullying	bully
begnawed	begnaw
berayed	beray
bouling	boule
buttonholes	buttonhole
broken into	break
bluest	blue
bummling	bummle
bangs up	bang up
bewrapping	bewrap
blindstitched	blindstitch
browning out	brown out
babbitted	babbitt
banalises	banalise
blarmed	euphemism
bemulces	bemulce
breezier	breezy
blindstitches	blindstitch
belaced	belace
bloometh	bloom
blissed out	bliss out
backpacked	backpack
braining	brain
barbarising	barbarise
bleeping	bleep
begetteth	beget
bashed about	bash about
bullshits	bullshit
brought down the hammer	bring down the hammer
boldens	bolden
BVP	boundary value problem
boying	boy
blown over	blow over
brainstormed	brainstorm
bread-line	bread line
bibblebabbling	bibblebabble
bepowered	bepower
bynempt	bename
befriendeth	befriend
bipuvacaine	bupivacaine
backtags	backtag
bearing up	bear up
bepommeled	bepommel
besinging	besing
blobbed out	blob out
bears on	bear on
ballsing around	balls around
backports	backport
bifurcated	bifurcate
buckleth	buckle
bootjacking	bootjack
bustling	bustle
bifurcates	bifurcate
brims	brim
bemudded	bemud
borne witness	bear witness
Bolivianizes	Bolivianize
bethatches	bethatch
beaten down	beat down
betold	betell
buttoned	button
Bolivianized	Bolivianize
Buddhizes	Buddhize
bitten the bullet	bite the bullet
bethatched	bethatch
Bhd.	brotherhood
brailled	braille
bedying	bedye
brooded	brood
bedizens	bedizen
bumbast	bombast
beaked	beak
befogged	befog
backbended	backbend
blesse	bless
blackbagged	blackbag
beats the system	beat the system
buffets	buffet
backpedalling	backpedal
broidering	broider
Bank Holiday	bank holiday
brandying	brandy
bewields	bewield
badded	bad
bottom edging	bottom edge
biospeologist	biospeleologist
brides	bride
badder	bad
best-looking	good-looking
biggest	big
bigging up	big up
brided	bride
buz	buzz
biddest	bid
brang	bring
besmirching	besmirch
beginne	begin
brown bagged	brown bag
boarding	board
Borged	Borg
breaks out	break out
bittur	bittern
backfires	backfire
blissing out	bliss out
backfired	backfire
bulbectomizing	bulbectomize
bastonading	bastonade
besyde	beside
blew one's load	blow one's load
bloodies up	bloody up
bay'd	bay
bells the cat	bell the cat
busynesse	business
beflags	beflag
ballsed about	balls about
baptizin'	baptizing
bamboozling	bamboozle
blighting	blight
berating	berate
blotching	blotch
barnstorming	barnstorm
backsheeshed	backsheesh
blazeth	blaze
bundle	dogpile
bylining	byline
bestuck	bestick
bankrupcy	bankruptcy
beathed	beath
bakes	bake
bituminises	bituminise
bemonstered	bemonster
bottles up	bottle up
baken	Alternative past participle
bituminised	bituminise
baked	bake
balming	balm
bagpipe	bagpipes
bemerded	bemerd
bought up	buy up
bemoistens	bemoisten
brandering	brander
bipolarizing	bipolarize
botting	bot
BOCS	bimodules over category
boxing the compass	box the compass
bechatting	bechat
birthday-boy	birthday boy
bulbectomizes	bulbectomize
bobbitting	bobbitt
breweth	brew
butyleneglycol	butanediol
bursting into flames	burst into flames
balmified	balmify
blandifies	blandify
boarding out	board out
boogieboarding	boogieboard
blandified	blandify
balmifies	balmify
brawliest	brawly
bamfoozled	bamfoozle
barhopping	barhop
bamfoozles	bamfoozle
barracks	barrack
botyroid	botryoid
Booktuber	booktuber
boweling	bowel
blew up someone's phone	blow up someone's phone
budging up	budge up
buys off on	buy off on
beated	beat
bosome	bosom
burliest	burly
beaten	beat
bandying	bandy
biner	abbreviation
burglarise	burglarize
bemouths	bemouth
birdcalls	birdcall
brangling	brangle
bearhugging	bearhug
built down	build down
broke into	break into
bloomed	bloom
bandsawing	bandsaw
BMed	BM
bitchslapping	bitchslap
birthday-card	birthday card
booped	boop
buttoned up	button up
begloomed	begloom
bequeatheth	bequeath
betokened	betoken
bed-hops	bed-hop
besped	bespeed
bonier	bony
boy friend	boyfriend
bonking	bonk
buys it	buy it
beribboning	beribbon
buncoed	bunco
boomed	boom
bewaving	bewave
brusht	brush
bullshitting	bullshit
beats one's swords into ploughshares	beat one's swords into ploughshares
billowing	billow
becouraging	becourage
beshines	beshine
Banbury story	Banbury story of a cock and a bull
besouling	besoul
braditrophy	bradytrophy
brushes up	brush up
brandishing	brandish
BCGs	birth control glasses
boldest	bold
buttering	butter
blasts off	blast off
blessedst	bless
B.Cl.	bass clarinet
befo'	before
Bangladeshizing	Bangladeshize
besmalls	besmall
bothe	both
befinds	befind
barble	barbel
by in large	by and large
brought upon	bring upon
besnowing	besnow
beating the bishop	beat the bishop
benefactour	benefactor
borne down	bear down
backstitched	backstitch
befreezing	befreeze
boaking	boak
backstitches	backstitch
bullshittiest	bullshitty
bewriting	bewrite
battologised	battologise
brutalizing	brutalize
biting off	bite off
borest	bear
bedipping	bedip
burls	burl
battologises	battologise
boystrous	boisterous
becurtains	becurtain
broided	broid
backpedals	backpedal
brainwipes	brainwipe
brainwiped	brainwipe
bestudding	bestud
beslobbers	beslobber
bevered	bever
boloing	bolo
boinging	boing
bentshed	bentsh
bosonising	bosonise
Britishizing	Britishize
biocalcified	biocalcify
broomed	broom
bentshes	bentsh
besotten	besot
bubblest	bubble
besotted	besot
bejumbling	bejumble
bivvying	bivvy
blorping	blorp
bushhammering	bushhammer
bogarted	bogart
brashiest	brashy
bails	bail
blots	blot
bulletinizing	bulletinize
breaks bulk	break bulk
BookTuber	booktuber
breaking down	break down
bourgeoned	bourgeon
Bedouin	bedouin
bearly	burly
blurrier	blurry
butteriest	buttery
bombing around	bomb around
bulldozering	bulldozer
balbutiates	balbutiate
berhymed	berhyme
bemeaning	bemean
bummles	bummle
boundance	abundance
brings down	bring down
becalming	becalm
banning	ban
blockheading	blockhead
blames	blame
bashfuller	bashful
brow-beaten	brow-beat
blunderbussed	blunderbuss
biocoding	biocode
bringest	bring
boosting	boost
bodyjacking	bodyjack
blared	blare
BTU	British thermal unit
band-aided	band-aid
blackmailing	blackmail
BTX	botulinum toxin
BTE	w:Boltzmann equation
bedogs	bedog
BTC	betacellulin
bokes	boke
BTO	build-to-order
BTK	Bruton's tyrosine kinase
broids	broid
braaing	braai
brayne	brain
bemisting	bemist
bacculoviral	baculoviral
bandaged	bandage
betwaddling	betwaddle
blunts	blunt
bespurts	bespurt
broaching	broach
backreading	backread
bemoiled	bemoil
bescreens	bescreen
bucketed	bucket
boggier	boggy
brushes	brush
besparkling	besparkle
begged to differ	beg to differ
barraging	barrage
biglie	bigly
bloated	bloat
Borked	borked
bulleting	bullet
boked	boke
bestealing	besteal
backrolled	backroll
befrilled	befrill
building down	build down
blickened	blicken
beastial	bestial
boulstering	boulster
bore with	bear with
backdated	backdate
bumpfired	bumpfire
bestializing	bestialize
balder	bald
balling	ball
bisprectal	bispectral
backdates	backdate
balded	bald
bleching	blech
balefullest	baleful
bilding	building
became one flesh	become one flesh
bloomiest	bloomy
bathocuprione	bathocuproine
blue petering	blue peter
bewraps	bewrap
beslobbering	beslobber
befleas	beflea
besighed	besigh
brown bagging	brown bag
brevic.	breviculum
bushwalking	bushwalk
blinkin'	blinking
broasted	broast
burgundy	Burgundy
Bio	biology
bluing	blue
bebarring	bebar
biHamiltonian	bihamiltonian
bioluminiscent	bioluminescent
bestreaks	bestreak
borrowed	borrow
beagled	beagle
blenches	blench
babifies	babify
beties	betie
blinking	blink
blemisht	blemish
BLUF	bottom line up front
babified	babify
blenched	blench
back-channeling	back-channel
borrowes	borrowe
begirdled	begirdle
blow-waving	blow-wave
beads	bead
blopped	blop
boggling	boggle
boxes in	box in
beleeve	believe
besticks	bestick
bediapering	bediaper
bats out	bat out
bandishes	bandish
bewrinkled	bewrinkle
brain-stormed	brain-storm
bandished	bandish
bonnier	bonny
bitching out	bitch out
betwattling	betwattle
begowks	begowk
beggarlier	beggarly
bummest	bum
blacks up	black up
braditroph	bradytroph
beletters	beletter
bellowing	bellow
beslavered	beslaver
blankens	blanken
brushing one's teeth	brush one's teeth
BLQ	broad emission-line quasar
Blotto	blotto
bewrites	bewrite
bollocksed	bollocks
buzzes off	buzz off
boodied	boody
Blu-Tacked	Blu-Tack
bollockses	bollocks
ballotting	ballot
blasted	blast
beeps	beep
biccuculine	bicuculline
bilingualizing	bilingualize
broke the ice	break the ice
beetrooting	beetroot
bielded	bield
betting	bet
babelizes	babelize
bedights	bedight
bespatters	bespatter
Bangaloring	Bangalore
BEWD	blue
babelized	babelize
buzzest	buzz
beeg	big
blowes	blowe
becalmed	becalm
bo-peeped	bo-peep
blowed	blow
boweled	bowel
besprinkles	besprinkle
burning the candle at both ends	burn the candle at both ends
bettin'	betting
befogging	befog
betrothing	betroth
berms	berm
beginking	begink
buproprion	bupropion
balkanization	Balkanization
battened	batten
brewed	brew
bestowest	bestow
boated	boat
ballparking	ballpark
blazoneth	blazon
boo-booed	boo-boo
brightlier	brightly
beweeps	beweep
barrel jumping	barrel jump
beautifuler	beautifuller
ballyragging	ballyrag
bears down	bear down
bosses about	boss about
Bus.	business
boondocking	boondock
bunkering	bunker
battelling	battel
backstabbed	backstab
butted in	butt in
bullered	buller
bliving	blive
botrytized	botrytize
Brazilian waxed	Brazilian wax
brenned	bren
bugged	bug
bramblier	brambly
breaching	breach
battling out	battle out
bled white	bleed white
Baiduing	Baidu
Bates numbered	Bates number
butlering	butler
brumating	brumate
brainstorming	brainstorm
breakfasted	breakfast
bales out	bale out
bands	band
brainiest	brainy
burne	burn
bungling	bungle
beachcombing	beachcomb
burns	burn
breake	break
broadcasted	broadcast
beginnest	begin
backtrolling	backtroll
bishop of Rome	Bishop of Rome
blacklisted	blacklist
boxhauling	boxhaul
buttonizing	buttonize
bedsharing	bedshare
balloting	ballot
blackifying	blackify
backs out	back out
bishopped	bishop
beheld	behold
bhangi	Bhangi
baing	ba
bridging the gap	bridge the gap
booking	book
beneficiates	beneficiate
beshears	beshear
bogeying	bogey
brainfucking	brainfuck
blooped	bloop
blabbed	blab
benzoid	benzenoid
boozier	boozy
badgers	badger
beliving	belive
ballroomed	ballroom
beehived	beehive
betreads	betread
bats	bat
blabbers	blabber
beehives	beehive
breathing in	breathe in
bodie	body
backshot	backshoot
bootlegging	bootleg
beribbons	beribbon
buccaniering	buccanier
begowned	begown
B/U	back-up
B/L	bill of lading
bobbitise	Bobbittise
beerier	beery
backchannels	backchannel
BAFC	below-average frustrated chump
bleacht	bleach
begnawing	begnaw
bottlenecks	bottleneck
bimbling	bimble
Bahuvrihi	bahuvrihi
barest	bear
bourgeoising	bourgeois
BRT	bus rapid transit
BRS	booking reservation system
behelms	behelm
biobanked	biobank
bedabbling	bedabble
brunoising	brunoise
biopsying	biopsy
breaking wind	break wind
bad-mouthing	bad-mouth
ballses on	balls on
borry	borrow
bethwacked	bethwack
blesseth	bless
beheading	behead
bandited	bandit
behedging	behedge
bequesting	bequest
bedtyme	bedtime
BMXed	BMX
beastliest	beastly
bodyslammed	bodyslam
brownifying	brownify
black-bags	black-bag
blenderizes	blenderize
bulled	bull
belamming	belam
betokenest	betoken
blebbing	bleb
blottest	blot
bodyslamming	bodyslam
Bœotian	Boeotian
bewhoring	bewhore
brightens up	brighten up
barfs	barf
bejewels	bejewel
begriped	begripe
bestained	bestain
blissens	blissen
binnering	binner
bedeafens	bedeafen
beweighing	beweigh
bests	best
burring	burr
blemishes	blemish
buries the hatchet	bury the hatchet
bluffs	bluff
betterest	better
blithering	blither
burned down	burn down
blouded	bloud
Bengalizing	Bengalize
blown out	blow out
beating	beat
browserifying	browserify
burnt to a crisp	burn to a crisp
battled out	battle out
BNOC	big name on campus
bowkin	bowk
briefened	briefen
blasphemeth	blaspheme
baled	bale
backsets	backset
bimimetic	biomimetic
bearproofed	bearproof
beseeching	beseech
botching up	botch up
bombing out	bomb out
bales	bale
begins with the chucky	begin with the chucky
bonging	bong
Byzantinized	Byzantinize
bowdlerises	bowdlerise
Bramin	brahmin
bishoped	bishop
bowdlerised	bowdlerise
beautifull	beautiful
Byzantinizes	Byzantinize
boom-booming	boom-boom
begowked	begowk
berisps	berisp
buccaneered	buccaneer
balmed	balm
beshielded	beshield
blandest	bland
barfing	barf
boxing someone's ears	box someone's ears
bibbing	bib
besought	beseek
bedutches	bedutch
baby-talked	baby-talk
bleated	bleat
bringing up short	bring up short
brickfilms	brickfilm
bravelier	bravely
besmoothed	besmooth
becking	beck
broadeneth	broaden
bankrolling	bankroll
bewends	bewend
belating	belate
brambliest	brambly
boogalooed	boogaloo
buttoning	button
besmears	besmear
bouched	bouche
battologising	battologise
boohooing	boohoo
bedraws	bedraw
begallowed	begallow
banging about	bang about
bringing upon	bring upon
brûléeing	brûlée
barriering	barrier
blears	blear
bratticing	brattice
begs	beg
broke in	break in
biosilification	biosilicification
befools	befool
brevitoxin	brevetoxin
branches	branch
bounciest	bouncy
bumpering	bumper
ballbusting	ballbust
bronzier	bronzy
branched	branch
bogarting	bogart
brute forcing	brute force
boobying	booby
battle ship	battleship
boogieboarded	boogieboard
blowbanging	blowbang
busheling	bushel
blobbing	blob
beats off	beat off
blocked	block
baggage-claim	baggage claim
backported	backport
bitch-slapping	bitch-slap
bolusing	bolus
bemetes	bemete
blows off steam	blow off steam
burns the candle at both ends	burn the candle at both ends
boxing out	box out
boozing	booze
busted up	bust up
blueprints	blueprint
beating the system	beat the system
blew away	blow away
basturd	bastard
besorting	besort
busts	bust
besots	besot
begun	begin
busta	buster
bemonsters	bemonster
besuits	besuit
backgrounding	background
beamed up	beam up
blinkest	blink
bugging	bug
begilded	begild
belimbed	belimb
bolts	bolt
bullyproofed	bullyproof
botoxing	botox
boobs	boob
buttonizes	buttonize
blizzards	blizzard
buttonized	buttonize
buprenorphene	Buprenorphene
broaches	broach
butterflied	butterfly
basificating	basificate
billingsgated	billingsgate
biofiltered	biofilter
best-known	well-known
broached	broach
brownnosing	brownnose
blossome	blossom
bebloodying	bebloody
betalking	betalk
breathiest	breathy
biomethylates	biomethylate
bitrophic	biotrophic
biomethylated	biomethylate
bepearled	bepearl
burying	bury
blinkled	blinkle
bedevilling	bedevil
bloviating	bloviate
blows up someone's phone	blow up someone's phone
bravening	braven
bluebooking	bluebook
besitting	besit
bullyproofs	bullyproof
brawning	brawn
bespoils	bespoil
boobfeeds	boobfeed
benetting	benet
B/E	bill of exchange
Bremained	Bremain
band-aiding	band-aid
biotinylating	biotinylate
BPA	bisphenol A
bows and scrapes	bow and scrape
blitzing	blitz
BPH	benign prostatic hyperplasia
BPL	broadband over power line
BPO	business process outsourcing
boilin'	boiling
BPS	w:battered person syndrome
bulking	bulk
been there	be there
beddeth	bed
blunk	blink
babying	baby
broadcasting	broadcast
battened down	batten down
breathed out	breathe out
becrazed	becraze
broken loose	break loose
bowering	bower
boiling	boil
becrazes	becraze
bibliog.	bibliography
burstiest	bursty
beweaponing	beweapon
beaded	bead
blvd.	boulevard
blindstitching	blindstitch
bawling	bawl
backflushes	backflush
basseted	basset
beggin'	begging
breaketh	break
bediapered	bediaper
beflecks	befleck
body surfs	body surf
backchanneling	backchannel
bagsied	bagsy
believing	believe
bushier	bushy
bosting	bost
bastinadoing	bastinado
boyle	boil
bawlin'	bawling
broadest	broad
besmudged	besmudge
BoNT	botulinum neurotoxin
bushhammers	bushhammer
ballasting	ballast
besmudges	besmudge
baudric	baldrick
bowls over	bowl over
boxes out	box out
barretted	barrette
braves	brave
bringing up against	bring up against
believin'	believing
befangs	befang
beadier	beady
beholding	beholden
bids	bid
brickling	brickle
batmitzvah	bat mitzvah
BLEVE	boiling liquid expanding vapor explosion
bedemoned	bedemon
brachiating	brachiate
bottomed on	bottom on
bleynte	blench
belittles	belittle
booby-traps	booby-trap
belittled	belittle
brinier	briny
buildest	build
barging	barge
bisects	bisect
beflees	beflee
butt dials	butt dial
bitest	bite
bogging down	bog down
bebothered	bebother
bedwarfs	bedwarf
bunks	bunk
birthday-cake	birthday cake
buriall	burial
breveted	brevet
bricks	brick
blessin'	blessing
babbling	babble
batting for both sides	bat for both sides
blimping out	blimp out
bosted	bost
babymooning	babymoon
barmier	barmy
brittler	brittle
bovrilised	bovrilise
bequeathed	bequeath
bestemmed	bestem
bullyrags	bullyrag
biotransforms	biotransform
backheeled	backheel
blessing	bless
boiled up	boil up
bollocked	bollock
bloodserum	blood serum
befortuning	befortune
bowging	bowge
beducking	beduck
bepurpling	bepurple
bejades	bejade
buys into	buy into
backfills	backfill
busting the dust	bust the dust
bowed out	bow out
bit down	bite down
biotyped	biotype
boatlifted	boatlift
bobbled	bobble
bowe	bow
botching	botch
bloviates	bloviate
bastardises	bastardise
boomeranged	boomerang
breaks down	break down
bobbles	bobble
buys	buy
brake tests	brake test
bastardised	bastardise
babbitting	babbitt
becringes	becringe
barges	barge
best-timed	well-timed
bottling up	bottle up
barged	barge
becringed	becringe
boldlier	boldly
backpaddled	backpaddle
bodied	body
bleakest	bleak
backpaddles	backpaddle
blonding	blond
breaks loose	break loose
bodies	body
blows out	blow out
bedashes	bedash
bemows	bemow
boiling up	boil up
broiding	broid
burns out	burn out
bescorched	bescorch
brigge	bridge
bescorches	bescorch
balkanising	balkanise
bloo	blew
bleats	bleat
bifurcating	bifurcate
begattest	beget
boofed	boof
banhammered	banhammer
bellyached	bellyache
befeathers	befeather
buncoing	bunco
BBEG	big bad evil guy
babbleth	babble
buoyed up	buoy up
beneficed	benefice
buddies	buddy
beefier	beefy
buxomer	buxom
besmiling	besmile
buddied	buddy
bayted	bayt
burdens	burden
barretting	barrette
better-timed	well-timed
benchslapping	benchslap
biohydrogenating	biohydrogenate
blipping	blip
bubbling up	bubble up
befortunes	befortune
broke down	break down
beaches	beach
breaking and entering	break and enter
befooling	befool
behindest	behind
beknighting	beknight
bespeeds	bespeed
buttling	buttle
blackguarding	blackguard
bedirties	bedirty
buys off	buy off
blow-drying	blow-dry
bedirtied	bedirty
befitted	befit
buds	bud
begabs	begab
back-burners	back-burner
beelines	beeline
bumped off	bump off
budg	budge
bludgeoned	bludgeon
beelined	beeline
besorts	besort
bupivicaine	bupivacaine
bears with	bear with
buffooned	buffoon
befel	befal
bimeby	by and by
blenderized	blenderize
butting in	butt in
black rhino	black rhinoceros
bungs up	bung up
BRONJ	bisphosphonate
bemoystens	bemoysten
been a thing	be a thing
bullers	buller
bicycling	bicycle
backpacks	backpack
bebathes	bebathe
biggens	biggen
brushed up	brush up
botoxes	botox
beatificates	beatificate
buzzling	buzzle
bewails	bewail
bounded	bound
boobytrapped	boobytrap
browbeats	browbeat
brast	burst
botoxed	botox
booked	book
binge-watches	binge-watch
bellyaching	bellyache
bebusying	bebusy
beggareth	beggar
bristliest	bristly
binge-watched	binge-watch
bangling	bangle
bequeathing	bequeath
belongin'	belonging
bayonetting	bayonet
barons	baron
batting in	bat in
BMR	biomedical research
besmoking	besmoke
blenching	blench
bemuds	bemud
bulks out	bulk out
better late then never	better late than never
bloudy	bloody
black-letter	black letter
bathrocuproine	bathocuproine
bubbled	bubble
ballsing about	balls about
bubbles	bubble
begripes	begripe
beghosts	beghost
boults	boult
becked	beck
booting	boot
bastardising	bastardise
bopped	bop
brusheth	brush
bolteth	bolt
better-intentioned	well-intentioned
bemoaned	bemoan
bolned	boln
bodyblocked	bodyblock
booing	boo
bossing	boss
bespoken	bespeak
boileth	boil
belies	belie
boded	bode
bats for both sides	bat for both sides
bodes	bode
badinages	badinage
boinking	boink
bawls out	bawl out
battles out	battle out
badinaged	badinage
bulle	bull
blander	bland
behowling	behowl
broke off	break off
blanded	bland
branded	brand
boskier	bosky
brothah	brother
black boxing	black box
bechalking	bechalk
benefitt	benefit
bynamed	byname
bolixing	bolix
birdcalling	birdcall
botched up	botch up
better off	well off
blockier	blocky
bitmasked	bitmask
birdcalled	birdcall
belled the cat	bell the cat
burthening	burthen
begs to differ	beg to differ
buck dancing	buck dance
banding	band
backpacking	backpack
breaking	break
blazons	blazon
beleaves	beleave
broke the fourth wall	break the fourth wall
Bœotic	Boeotic
bashes about	bash about
backlisted	backlist
blicks	blick
bebeasts	bebeast
befurbelows	befurbelow
builded castles in the air	build castles in the air
barbs	barb
bemoistened	bemoisten
bescorning	bescorn
biostimulating	biostimulate
brotha	brother
beachier	beachy
bartering	barter
beweapons	beweapon
breaking one's lance	break one's lance
bespeckled	bespeckle
built on	build on
banjaxes	banjax
bespeckles	bespeckle
bouy	buoy
banjaxed	banjax
bigged	big
bronchioloar	bronchiolar
bombasted	bombast
bohemianism	Bohemianism
beguilest	beguile
busting a nut	bust a nut
blackberrying	blackberry
bigger	big
benews	benew
behesting	behest
bird dogs	bird dog
blackboards	blackboard
backfitted	backfit
boardwalking	boardwalk
burprenorphine	buprenorphine
bolstering	bolster
blowier	blowy
butt-raping	butt-rape
besnowed	besnow
buffetted	buffet
binding on pickup	bind on pickup
braided	braid
brooched	brooch
backlists	backlist
beslubbered	beslubber
begalling	begall
bolloxed	bollox
bibbed	bib
buke muslin	book muslin
batiking	batik
blaring	blare
bootlicked	bootlick
battening down the hatches	batten down the hatches
bemisted	bemist
biggering	bigger
becrazing	becraze
backslides	backslide
bellying up	belly up
beaten off	beat off
biddedst	bid
betags	betag
béchamel	béchamel sauce
booking it	book it
bisexualizing	bisexualize
bombed out	bomb out
bringing off	bring off
ballyhoos	ballyhoo
balancable	balanceable
brisked	brisk
bennies	benny
begayed	begay
boffs	boff
Burtonizing	Burtonize
befalls	befall
belectured	belecture
bookending	bookend
belectures	belecture
bibiliography	bibliography
borroweth	borrow
buckramed	buckram
butylaldehyde	butyraldehyde
battening down	batten down
busts out	bust out
behandled	behandle
bageling	bagel
banging	bang
bisket	biscuit
bugging out	bug out
behandles	behandle
boondoggling	boondoggle
boilerplating	boilerplate
bedews	bedew
bedriven	bedrive
bedrives	bedrive
blimping	blimp
bucking up	buck up
beribboned	beribbon
beganst	begin
barhopped	barhop
Bengalized	Bengalize
boycotting	boycott
boarded out	board out
buccans	buccan
battened down the hatches	batten down the hatches
birthdayed	birthday
bidest	bide
browzing	browze
becleping	beclepe
blippier	blippy
bestars	bestar
bashfulest	bashful
banging around	bang around
belirting	belirt
benchslapped	benchslap
belaves	belave
backstepped	backstep
bethumbed	bethumb
backdoored	backdoor
begloried	beglory
bringing about	bring about
bounced back	bounce back
buoying	buoy
bioavailibility	bioavailability
bebroke	bebreak
balancing the books	balance the books
beards	beard
beglories	beglory
backtabbed	backtab
buzzsawing	buzzsaw
best off	well off
brags on	brag on
bars	bar
belaid	belay
basilectalizes	basilectalize
becroggles	becroggle
brunted	brunt
bacteriovorous	bacterivorous
blurts out	blurt out
bringing up	bring up
birred	birr
banisheth	banish
boaked	boak
beshakes	beshake
bemixed	bemix
blamestormed	blamestorm
brooketh	brook
blurs	blur
bemixes	bemix
Blu-Tacking	Blu-Tack
bepeppers	bepepper
bilinearizes	bilinearize
bitmasking	bitmask
brasher	brash
bilinearized	bilinearize
brashed	brash
bibs	bib
blazes	blaze
backtrolled	backtroll
basketing	basket
bipolarised	bipolarise
blazed	blaze
became	become
beathing	beath
bailing out	bail out
behavest	behave
bipolarises	bipolarise
blandishing	blandish
boshed	bosh
beteemed	beteem
back dooring	back door
belling out	bell out
baptizing	baptize
Bp	bishop
bzzed	bzz
befrosted	befrost
betumbled	betumble
brokers	broker
bespurted	bespurt
buffest	buff
backsolved	backsolve
berascals	berascal
beasted	beast
backwaters	backwater
bitchslapped	bitchslap
belayed	belay
bespoke	bespeak
backsolves	backsolve
blurted	blurt
bottome	bottom
bangs about	bang about
boots up	boot up
brownest	brown
betroths	betroth
Bolivianizing	Bolivianize
bowls out	bowl out
badgering	badger
bombinates	bombinate
best-built	well-built
brooding	brood
breaks and enters	break and enter
bounces back	bounce back
brashing	brash
breakfasting	breakfast
beladying	belady
benigner	benign
bounced	bounce
blackjacked	blackjack
breastfeeding	breastfeed
bedazes	bedaze
bedde	bed
bedazed	bedaze
beering up	beer up
bleediest	bleedy
begannest	begin
belking	belk
bellhopping	bellhop
boobed	boob
bustiest	busty
bonniest	bonny
barring out	bar out
bollixed	bollix
belostomid	belostomatid
breeded	breed
blenderizing	blenderize
bollixes	bollix
brings out	bring out
becreeps	becreep
behedges	behedge
beraying	beray
bilingualized	bilingualize
billets	billet
breaks up	break up
baizing	baize
blindsiding	blindside
bashing about	bash about
bewore	beware
bilingualizes	bilingualize
belauds	belaud
brustled	brustle
begrudges	begrudge
bemocking	bemock
begrudged	begrudge
bushy-tailed	bright-eyed and bushy-tailed
boogered up	booger up
beleaguered	beleaguer
becloaks	becloak
beganne	began
besprinckled	besprinkled
brandeth	brand
bristling	bristle
bushwhacks	bushwhack
blowing over	blow over
bleeds	bleed
bespoiled	bespoil
broomiest	broomy
buxomest	buxom
bcc'd	bcc
bloused	blouse
booging	boog
blends in	blend in
browing	brow
belled out	bell out
behighted	behight
bcc's	bcc
begrudging	begrudge
barrin'	barring
bejewelling	bejewel
barfed	barf
bakest	bake
bittier	bitty
bluffing	bluff
bellyflops	bellyflop
branching	branch
beta reducing	beta reduce
bedags	bedag
belays	belay
bloodthirstier	bloodthirsty
backhands	backhand
befoir	before
blings out	bling out
barring	bar
beguilts	beguilt
beguiling	beguile
blacke saunts	black sanctus
brought owls to Athens	bring owls to Athens
banged around	bang around
bipping	bip
bounces off the walls	bounce off the walls
bewon	bewin
betaed	beta
boiling over	boil over
bureau-ocracy	bureaucracy
birdieing	birdie
Betamaxes	Betamax
backs	back
boy crazier	boy crazy
bespits	bespit
barkened	barken
bejesuiting	bejesuit
Betamaxed	Betamax
bubbled over	bubble over
bench bleeds	bench bleed
breasts	breast
bretzel	pretzel
bonding	bond
bcos	because
bcoz	because
bethralled	bethrall
bewinging	bewing
blacksplained	blacksplain
bestrewing	bestrew
blitted	blit
booleanizing	booleanize
breathin'	breathing
brings owls to Athens	bring owls to Athens
beakier	beaky
besetting	beset
beswinking	beswink
barbing	barb
binated	binate
beglamouring	beglamour
bemeting	bemete
befal	befall
betidest	betide
boulstered	boulster
breathing	breathe
beplastering	beplaster
backslapped	backslap
belutes	belute
bounding	bound
busting ass	bust ass
ball-busts	ball-bust
bicolourous	bicolorous
bedoctors	bedoctor
bloodthirstiest	bloodthirsty
broken the fourth wall	break the fourth wall
base-ball	baseball
bewets	bewet
bioaccumulating	bioaccumulate
buffeted	buffet
bases on	base on
blobs	blob
befinding	befind
beautifieth	beautify
blickening	blicken
birdiesat	birdiesit
boardwalked	boardwalk
blets	blet
Bankr.	bankruptcy
behues	behue
bugs out	bug out
becroggling	becroggle
bilocating	bilocate
blithered	blither
bespawling	bespawl
banalized	banalize
bickers	bicker
buirdlier	buirdly
banalizes	banalize
brawleth	brawl
bogues	bogue
Batmanned	Batman
bobtails	bobtail
bogued	bogue
bosts	bost
birdnapped	birdnap
bench bled	bench bleed
boasts	boast
bawdiest	bawdy
boldly gone where no man has gone before	boldly go where no man has gone before
berines	berine
backlashing	backlash
BYOB	Bring your own bible
buffiest	buffy
backstroked	backstroke
bebarks	bebark
breakin'	breaking
backstrokes	backstroke
bellies up	belly up
bevomiting	bevomit
B2B	back-to-back
begaying	begay
befits	befit
bemoist'ning	bemoisten
boo-booing	boo-boo
beastlier	beastly
boils up	boil up
beaten the bishop	beat the bishop
bloodiest	bloody
bereavest	bereave
backscatters	backscatter
brabbled	brabble
bunged	bung
broken even	break even
barrenest	barren
bequoth	bequeath
bedusting	bedust
brings to justice	bring to justice
backpatched	backpatch
begirded	begird
backtalks	backtalk
blusters	bluster
backslidden	backslide
benifit	benefit
babysat	babysit
begods	begod
backpatches	backpatch
boogying	boogie
barricaded	barricade
book of shadows	Book of Shadows
becaring	becare
bespews	bespew
brogging	brog
breadcrumbed	breadcrumb
bauffing	bauf
brings up to	bring up to
banyak	alternative form
badged	badge
bowstrung	bowstring
bikeshedded	bikeshed
bletting	blet
badges	badge
buckdancing	buckdance
bounced off the walls	bounce off the walls
badinaging	badinage
biodiversifying	biodiversify
byo	bayou
beheadest	behead
bezzling	bezzle
barrista	barista
belted	belt
bumbling	bumble
blackberries	blackberry
beslubbers	beslubber
blackberried	blackberry
bluesifying	bluesify
besmirched	besmirch
bogotifying	bogotify
beeing	being
besmoothing	besmooth
bilateralized	bilateralize
bodyslams	bodyslam
bowling out	bowl out
bttm	bottom
blameshifting	blameshift
backsliding	backslide
beveled	bevel
bills	bill
buccaned	buccan
bescrawled	bescrawl
begiven	begive
brushier	brushy
bebarred	bebar
beslaving	beslave
bulbectomized	bulbectomize
beaten to	beat to
blazened	blazen
boxing in	box in
blowsiest	blowsy
bennying	benny
boganned	bogan
brawled	brawl
beknows	beknow
bolshevising	bolshevise
BlackBerries	BlackBerry
basing on	base on
blinged out	bling out
bedazzles	bedazzle
bewatered	bewater
BlackBerried	BlackBerry
brooked	brook
bedazzled	bedazzle
beknown	beknow
beclothed	beclothe
barns	barn
battleth	battle
bedagged	bedag
bitch slapping	bitch slap
buoys up	buoy up
bellweather	bellwether
beclothes	beclothe
biting	bite
burns down	burn down
Boucherizing	Boucherize
bewags	bewag
bequotes	bequote
Borken	borken
bulks	bulk
bequoted	bequote
barrel raced	barrel race
baptizes	baptize
brewin'	brewing
belabored	belabor
beseemeth	beseem
bollocksed up	bollocks up
baptized	baptize
barrel races	barrel race
busts up	bust up
breastiest	breasty
belaborer	belabourer
Britpicks	Britpick
bashed	bash
best-grounded	well-grounded
Bobbittizes	Bobbittize
boring	bore
BuNo	bureau number
balkanism	Balkanism
bowssened	bowssen
broodeth	brood
bashes	bash
BLUP	best linear unbiased prediction
beblooding	beblood
behinde	behind
Bobbittized	Bobbittize
bebleeding	bebleed
bilinearizing	bilinearize
bigge	big
bloodening	blooden
brushest	brush
biggs	bigg
blameshifted	blameshift
benefiteth	benefit
buddying	buddy
brokedown	break down
boxcarring	boxcar
bewetting	bewet
beheard	behear
balkest	balk
babbitts	babbitt
bookmatching	bookmatch
beholdeth	behold
behears	behear
bringing to justice	bring to justice
braggier	braggy
BGA	blue-green alga
brutalizes	brutalize
blethering	blether
balding	bald
bulging	bulge
BGH	bovine growth hormone
bellied	belly
bedding out	bed out
brutalized	brutalize
blamest	blame
bassiest	bassy
bakshished	bakshish
bepestering	bepester
berisping	berisp
bottling	bottle
beyelping	beyelp
brought back	bring back
bogged	bog
bellycrawls	bellycrawl
betrusted	betrust
bebopping	bebop
backdropped	backdrop
ballrooming	ballroom
brouzed	brouze
beats around the bush	beat around the bush
belts	belt
binarchy	biarchy
barotrophy	barotropy
balladeering	balladeer
beteaching	beteach
beefiest	beefy
bulletined	bulletin
buzzes	buzz
brominating	brominate
buryal	burial
buzzed	buzz
beetling	beetle
believ'd	believe
besmeared	besmear
bursting out	burst out
biosynthesising	biosynthesise
breaks with	break with
beers up	beer up
bidnesses	business
Boucherized	Boucherize
backest	back
budgeting	budget
blewest	blow
Boucherizes	Boucherize
beetrooted	beetroot
blackboarding	blackboard
bookkeeps	bookkeep
benshee	banshee
bewritten	bewrite
bellycrawling	bellycrawl
backbites	backbite
bum-rushes	bum-rush
bycaught	bycatch
blottier	blotty
biosynthesizing	biosynthesize
bum-rushed	bum-rush
befortuned	befortune
bewildering	bewilder
bespicing	bespice
blending in	blend in
butchers	butcher
bedukes	beduke
bedded	bed
broddling	broddle
birde	bird
beduked	beduke
bearing with	bear with
boshing	bosh
befurred	befur
bituminates	bituminate
blousier	blousy
begilding	begild
birthdaye	birthday
bespawled	bespawl
bookier	booky
busting up	bust up
bituminated	bituminate
belted up	belt up
bummed out	bum out
bevvying	bevvy
beateth	beat
backslashed	backslash
befingers	befinger
brandished	brandish
bloodened	blooden
besting	best
brandwashing	brandwash
bumpier	bumpy
blound	blind
brandishes	brandish
BrdU	bromodeoxyuridine
bedeafening	bedeafen
bimbles	bimble
beclarts	beclart
behights	behight
beechiest	beechy
bimbled	bimble
bench pressing	bench press
bespeaketh	bespeak
bartends	bartend
banded	band
breaked	break
bethanked	bethank
bending	bend
bandileer	bandoleer
balkiest	balky
bequivered	bequiver
befoams	befoam
backprojecting	backproject
bemeted	bemete
byhearting	byheart
bating	bate
ballaragging	ballarag
bespreading	bespread
belaboureth	belabour
belle esprit	bel esprit
bendin'	bending
bushwacked	bushwack
becarves	becarve
bearing upon	bear upon
becarved	becarve
beburying	bebury
befuddled	befuddle
betitled	betitle
betaing	beta
bakstone	bakestone
betitles	betitle
breedest	breed
bullwhipping	bullwhip
Biblical	biblical
blubbering	blubber
bossed	boss
bivouacked	bivouac
blushest	blush
bosses	boss
BMOC	big man on campus
beneathe	beneath
beglamors	beglamor
besung	besing
ballses up	balls up
bruting	brute
biomineralised	biomineralise
brownnoses	brownnose
betrodden	betread
bloquing	bloque
bursts out	burst out
brownnosed	brownnose
begrouched	begrouch
beered up	beer up
blacklines	blackline
broddled	broddle
blathered	blather
bearing in with	bear in with
biomedicalized	biomedicalize
brawls	brawl
bebangs	bebang
broddles	broddle
blacklined	blackline
biomedicalizes	biomedicalize
besmirches	besmirch
bashfullest	bashful
butt dialed	butt dial
blanketed	blanket
brazens	brazen
blows the whistle	blow the whistle
buying out	buy out
BIOS	w:BIOS
bollixing	bollix
blue lights	blue light
banshie	banshee
boiled over	boil over
beweeping	beweep
bedrapes	bedrape
bitches	bitch
brassier	brassy
blackenizing	blackenize
bedraped	bedrape
bureaucratized	bureaucratize
bridleth	bridle
brunoised	brunoise
bereaves	bereave
breedin'	breeding
bullyragging	bullyrag
bennied	benny
bikejored	bikejor
buffs	buff
boarding up	board up
bombarding	bombard
biting the dust	bite the dust
breakiest	breaky
balances the books	balance the books
breadthened	breadthen
beglammering	beglammer
besmoked	besmoke
built up	build up
boos	boo
besmokes	besmoke
body surfing	body surf
blendeth	blend
backronymed	backronym
booting up	boot up
brangles	brangle
blabbing	blab
buggered off	bugger off
borne with	bear with
bwoy	boy
bandiest	bandy
bastonaded	bastonade
bludy	bloody
breathed in	breathe in
bastonades	bastonade
bereaved	bereave
