'swounds	zounds
'dswounds	'swounds
15 minutes	15 minutes of fame
2XL	XXL
4G LTE	LTE
astromicrobiology	xenomicrobiology
asinary	asinine
antithermic	antipyretic
aspersory	aspersorium
angiosclerosis	atherosclerosis
angular harp	angle harp
arytenoepiglottidean	aryepiglottic
anakhré	goundou
allotroph	heterotroph
amidone	methadone
artificial tear drop	artificial tear
adermin	pyridoxine
absorbative	absorbent
airponics	aeroponics}}
ambassadry	ambassadorship
antigravity yoga	aerial yoga
atebrine	mepacrine
atoxic	nontoxic
angiographist	angiographer
aerographical	aerographic
addiment	complement
autosphenotic	sphenotic
action film	action movie
age of discretion	age of reason
anachrony	anachronism
aminotoluene	toluidine
amorphia	amorphism
adjustable wrench	adjustable spanner
anguidine	diacetoxyscirpenol
antiovulant	anovulant
alphadione	althesin
Arkansasian	Arkansan
abnormalism	abnormality
Alhambraic	Alhambresque
algesthesia	nociception
act the giddy goat	act the goat
archipelagal	archipelagic
anti-fact	lie
autopterotic	pterotic
autoassembly	self-assembly
actinophytosis	actinomycosis
antibiofouling	antifouling
anima mundi	world soul
antimelanogenesis	antimelanogenic
Afghan	Afghan Hound
amylamine	pentylamine
alertless	unalert
azocarminium	azocarmine
avirulency	avirulence
ammonid	ammonite
asemasia	asemia
acculturize	acculturate
azapropazone	apazone
aminotransaminase	aminotransferase
argentinoid	argentiniform
A-bomb maiden	Hiroshima maiden
aumil	amildar
astrolinguistics	xenolinguistics
ah well	oh well
aminylium	nitrenium
asymmetrical warfare	asymmetric warfare
adrenocortex	adrenal cortex
angiomyoneuroma	glomangioma
apathetical	apathetic
amidopyrine	aminophenazone
adriablastin	doxorubicin
adenocarcinomal	adenocarcinomic
Adam's wine	Adam's ale
anti-heterosexual	heterophobe
autoubiquitylate	autoubiquitinate
acute membranous gingivitis	acute necrotizing ulcerative gingivitis
arsenious acid	arsenic trioxide
angel lute	angélique
arithmetical progression	arithmetic progression
antiproliferating	antiproliferative
autotoxication	autointoxication
adrenalectomization	adrenalectomy
acetovanillone	apocynin
asymbolia	asemia
archaeocyte	amoebocyte
arkansite	brookite
antiprogestogen	antiprogestin
anthropomorphistic	anthropomorphic
antimonotonic	antimonotone
antilipolysis	antilipolytic
atloaxoid	atlantoaxial
activo-passive	mediopassive
activization	activation
allozymatic	allozymic
armarian	armarius
agglutinize	agglutinate
athyrosis	athyroidism
anticoccidian	anticoccidial
agaricinic acid	agaricic acid
Arkansasan	Arkansan
anaphorical	anaphoric
airgram	aerogram
anti-Shia	anti-Shiite
angelica	angélique
artificious	artificial
Areopagist	Areopagite
aprocarb	propoxur
autopeptidase	autoprotease
ascarosis	ascariasis
aklavine	aclacinomycin
areographical	areographic
autocrinously	autocrinally
artificial dumbness	artificial stupidity
anarchistical	anarchistic
artificial idiocy	artificial stupidity
antipapalism	antipapism}}
antirecessionary	antirecession
asleep at the wheel	asleep at the switch
antidormant	antidormancy
autogressive	autoregressive
astrobacteriology	xenobacteriology
antitrypanocidal	trypanocidal
aggregable	aggregatable
arachnophobic	arachnophobe
altimetrical	altimetric
Abyssinian wolf	Ethiopian wolf
albinuria	albiduria
airport novel	airport book
ad hocly	ad hoc
acylamidase	amidase
African Eve	Mitochondrial Eve
aminophen	acetaminophen
arsenicalism	arseniasis
a smidgen	a tad, a mite, a bit, a little}}
actinozoan	actinozoon
arboroid	arborescent
acroamatical	acroamatic
anterocingulid	anterolophid
arsabenzene	arsinine
armónico guitar	armónico
appeal to emotion	argumentum ad passiones
adipoblast	lipoblast
acrosomic	acrosomal
autodetachment	autoionization
allachesthesia	allesthesia
anyroads	anyroad
Ayyubite	Ayyubid
alarmistic	alarmist
aclonal	solitary
acute ulcerative gingivitis	acute necrotizing ulcerative gingivitis
astrobotany	xenobotany
anticacochymic	anticachectic
adenia	lymphadenia
amokura	red-tailed tropicbird
antihypercholesterolemia	antihypercholesterolemic
anthropometrics	anthropometry
all over but the crying	all over but the shouting
aeolodion	aeolodicon
abbey token	abbey counter
antithromboplastin	anticonvertin
aspermatism	aspermia
airline ticket	air ticket
amniochorionic	amniochorial
allosterism	allostery
adder's wort	adderwort
araponga	bare-throated bellbird
adenolymphitis	lymphadenitis
Ameriklan	Amerikkkan
antimicrobiotic	antimicrobial
aqua aerobics	water aerobics
adipogenetic	adipogenic
acetarsone	acetarsol
acceptance	etendue
Abram cove	Abraham man
abruptively	abruptly
atrichosis	atrichia
algesiometer	algometer
aquamation	alkaline hydrolysis
alantol	inulol
astroanthropology	xenoanthropology
arecaine	arecaidine
alkyl halide	haloalkane
accounting year	fiscal year
argosol	cambisol
agnosopsia	blindsight
abaya	aba
antineoplasm	antineoplastic
ataxiameter	ataxiagraph
atomic fusion	nuclear fusion
alloploidy	allopolyploidy
artificial incompetence	artificial stupidity
alackaday	alack
arabinanase	arabinase
allogenous	allogeneic
apothecarist	apothecary
atlantoepistrophic	atlantoaxial
acoustic bass	acoustic bass guitar
Abazin	Abaza
alloisomerism	geometric isomerism
antimony yellow	Naples yellow
Adamian	Adamite
apparatus criticus	critical apparatus
abwe	sekere
azin	pyridine
allylbenzene	phenylpropene
anadicrotic	anacrotic
archaeocyathan	archaeocyathid
albinoid	albino
adoptee	adopter
atypism	atypia
antisticking	antistick
antitwilight arch	belt of Venus
Arabian tea	Abyssinian tea
Abert's pipilo	Abert's towhee
aminoacetate	glycinate
anancastic	obsessive-compulsive
antischizophrenia	antischizophrenic
animal experimentation	animal testing
Argentinan	Argentine
armourhead	boarfish
anybody's guess	anyone's guess
accretionary prism	accretionary wedge
archism	hierarchism
anthropopathical	anthropopathic
autoactivity	autoreactivity
autophagocytic	autophagocytotic
Alzheimer's syndrome	Alzheimer's disease
amytal	amobarbital
alpinist	alpine skier}}
astroarchitecture	xenoarchitecture
autoimmunogenic	autoantigenic
amithiozone	thioacetazone
Augustin	English
androstanolone	dihydrotestosterone
agroterror	agroterrorism
arctometatarsus	arctometatarsal
aurora glass	carnival glass
aulete	flautist
aerodynamical	aerodynamic
Anglistics	English studies
asynchronic	asynchronous
adyton	adytum
acoustoelectrically	electroacoustically
autoradiogram	autoradiograph
aldoketose	ketoaldose
acolutholect	satellect
actidione	cycloheximide
aneuploidism	aneuploidy
abrasor	abrader
abacillary	abacterial
anthrapyrazolone	pyrazoloanthrone
authenticate	authentic
alveololabial	labioalveolar
aniacinosis	aniacinamidosis
argand	Argand lamp
Aleppoan	Aleppine
allopregnane	5α-pregnane
atomic fission	nuclear fission
asequence	arrhythmia
aquagym	water aerobics
antibechic	antitussive
aseismatic	aseismic
artificial lack of intelligence	artificial stupidity
anti-Semiticism	anti-Semitism
anaferine	anapheline
age spot	liver spot
agriculturism	agriculturalism
alpargata	espadrille
angioembolization	embolization
amputee identity disorder	body integrity identity disorder
acromyotonus	acromyotonia
Archie Bunkerish	Archie Bunkeresque
Ayurvedic medicine	Ayurveda
anarcho-commie	anarcho-communist
almsfolks	almsfolk
abnormalcy	abnormality
arborol	dendrimer
autobasidium	holobasidium
astrotech	xenotech
anestrum	anestrus
antineurogenesis	antineurogenic
anhinga	darter
anancastia	obsessive-compulsive disorder
aquacrunk	wonky
aspect-oriented programming language	aspect-oriented language
Arizonian	Arizonan
air sock	windsock
archistriatum	arcopallium
acervulus	corpora arenacea
arch harp	arched harp
arteriolovenular	arteriolovenous
arranged spiritual	spiritual
asparaginic	aspartic
Aleppan	Aleppine
anticarcinogenesis	anticarcinogenic
apomine	apomorphine
alloploidization	allopolyploidization
azocoll	azocollagen
anovular	anovulatory
any day of the week	any day
adenylpyrophosphate	adenosine triphosphate
autoethnographical	autoethnographic
abruptive	abrupt
analytism	analyticity
adenocancer	adenocarcinoma
alkaluria	alkalinuria
American dollar	US dollar}}
allantoenteric	allantoic
African	negroid
Aukan	Ndyuka
antifungicide	fungicide
abdominal breathing	diaphragmatic breathing
ancipitous	ancipital
aurotherapy	chrysotherapy
Aden ulcer	Aleppo boil
artist's fungus	artist's conk
amphophilous	amphophilic
adelphopoiia	adelphopoiesis
alveolargenesis	alveologenesis
abacate	avocado
antihyperglycemia	antihyperglycemic
Aristophanic man	homo Aristophaneus
apoid	apoidean
appleringie	southernwood
assortative pairing	assortative mating
alpha-methylphenethylamine	amphetamine
aquabike	waterbike}}
autosomic	autosomal
air refresher	air freshener
American longhair	Maine Coon
aldadiene	canrenone
arthrorisis	arthroereisis
amboceptor	hemolysin
alloisomer	geometric isomer
aquabics	water aerobics
antiphagocytosis	antiphagocytic
autoplast	autograft
anti-Shi'a	anti-Shiite
Amidakuji	ladder lottery}}
antipyrexic	antipyretic
armarium	ambry
aid dog	service dog
amygdalose	gentiobiose
arc-boutant	flying buttress
anticholinergenic	anticholinergic
asparaginic acid	aspartic acid
autocrinous	autocrine
astrexine	chlorhexidine
allelomorph	allele
ampusand	ampersand
Abraham cove	Abraham man
artificial ice	synthetic ice}}
aureolic acid	plicamycin
antimer	enantiomer
automated test framework	test harness
acron	prostomium
arrector	erector
aces and eights	dead man's hand
Archimedean screw	Archimedes' screw
antisubstance	antimatter
aminochronological	aminostratigraphic
Aga Khanite	Sevener
away with the fairies	lost in thought
astroethics	xenoethics
anachronym	backronym
alloerotism	alloeroticism
Alpine horn	alphorn
anecdotically	anecdotally
autofretting	autofrettage
atomic power	nuclear power
argyriasis	argyria
autoassociator	autoencoder
aerophilous	aerophilic
autotoxicosis	autointoxication
autoprotonization	autoprotonation
anthropogony	anthropogenesis
Abert's finch	Abert's towhee
amicroscopic	submicroscopic
acroscleroderma	sclerodactyly
abdest	wudu
apportionate	apportioned
airponic	aeroponic}}
avornin	frangulin
arachic	arachidic
alpestrine	subalpine
as yet unknown	as-yet-unknown
anti-commie	anticommunist
autistic spectrum	autism spectrum}}
antisteroidal	antisteroid
autochaperone	autotransporter
angioneuromyoma	glomangioma
albumone	albuminone
antilymphocytic	antilymphocyte
antiprogesterone	antiprogestin
abbot on the cross	croziered abbot
anthropophilous	anthropophilic
anticonceptive	contraceptive
algesimeter	algometer
ambix	alembic
autocatalytical	autocatalytic
amylosphere	amylospheroid
abstinence ring	purity ring
alto horn	althorn
anterointernal	antero-internal
anteromiddle	anteromedial
adlay	Job's tears
ahistoric	ahistorical
argyrophil	argyrophilic
aw well	oh well
anergasia	neurasthenia
anthracenedione	anthraquinone
ammonia process	Haber process
acromoprotease	achromopeptidase
armonico	armónico
autosarcophagy	autocannibalism
aleukia	leukopenia
angiocholitis	cholangitis
araneosene	dolabellane
artificial unintelligence	artificial stupidity
African sacred ibis	sacred ibis
actimycin	azithromycin
atom physics	atomic physics
allocative	allocational
apple blight	fire blight
Atlas lion	Barbary lion
Albert	Albert chain
Abraham-cove	Abraham man
amphitrichate	amphitrichous
allochronous	allochronic
Asatruist	Asatruar
arciliuto	archlute
autoadministered	self-administered
allosomal	allosomic
ancience	ancientness
atloid	atlantooccipital
Alpine hat	Tyrolean hat
anthelone	urogastrone
Alabaman	Alabamian
adenylpyrophosphatase	ATPase
alizarin red	alizarin
aquaerobics	water aerobics
anticomplement	complement
asthmatic attack	asthma attack
apathic	apathetic
annoyant	annoying
autosporulation	autosporogenesis
Abram-cove	Abraham man
jeesh	sheesh
Japan earth	terra-japonica
jello salad	congealed salad}}
just-world fallacy	just-world hypothesis
jitterbug	diddley bow
Jesus H. Christ on a popsicle stick	Jesus Christ
Japanime	anime}}
Jesuitical	Jesuitic
Judeo-Bolshevik	Judeo-Bolshevist
joint household	joint family
jerrymunglum	camel spider
juxtamembranous	juxtamembrane
J/psi meson	J/psi particle
Japanese pizza	okonomiyaki}}
Japanese radish	daikon
jam rammed	jam-packed
Japanese rice ball	onigiri}}
Jerusalem pony	donkey
Judeo-Bolshevism	Jewish Bolshevism
job queue	batch queue
juristic person	legal person}}
jolting	shocking
jugrigger	inrigger
Johnsonism	Johnsonianism
jump lead	jumper cable
johnny	john
Jedburgh justice	Jeddart justice
Jekyll/Hyde syndrome	dissociative identity disorder
Japanese sweet potato	satsumaimo
justfully	rightfully
juridical person	legal person}}
jazz box	jazz square
jpsi	J/psi meson
jumping castle	bouncing castle
Jedwood justice	Jeddart justice
Julian date	Julian day
Job's syndrome	hyperimmunoglobulin E syndrome
Judaic harp	Jew's harp
joculous	jocular
jumping gene	transposon
Jew's-trump	Jew's harp
jambolan	jambul
jamoon	jambul
Japanimation	anime}}
jamun	jambul
jack stand	axle stand
jumbo daikon	Sakurajima radish
junk news	junk food news
juxtaoral organ	organ of Chievitz
Jamestown weed	jimsonweed
Jesus pin	Jesus nut
junior right	borough English
Judas chair	Judas cradle
Jesus hugger	Christian
ophthalmoscopical	ophthalmoscopic
overstay one's welcome	wear out one's welcome
oxobutyric	ketobutyric
oligocardia	bradycardia
organella	organelle
oopsadaisy	whoops-a-daisy
octahydrocurcuminoid	octahydrocurcumin
organization man	company man
overhanging	overhang
organomercury	organomercurial
optical microscope	light microscope
onos	epinetron
OC gas	pepper spray
owl monkey	douroucouli
one-nationism	one-nation conservatism
ontological proof	ontological argument
oh my Zeus	oh my God
oxocamphor	ketocamphor
oxengate	oxgang
obfustication	obfuscation
orchiditis	orchitis
orphanin	nociceptin
otologic	otological
oblique stroke	slash
otkaznik	refusenik
ostensoir	monstrance
open harp	angle harp
Okinawan purple potato	Okinawan sweet potato
otoacoustical	otoacoustic
ornithuran	ornithurine
oil radish	oilseed radish
overevaluation	overvaluation
obligatorization	obligatorification
ovideposition	oviposition
osteoadherin	osteomodulin
OC spray	pepper spray
osetrova	osetra
ovicaprine	ovicaprid
osteophagy	osteophagia
ocean tramp	tramp steamer
one fry short of a Happy Meal	one brick short of a full load
Oïl language	langue d'oïl
optoporation	photoporation
ovigenetic	oogenetic
oligosyndactylism	oligosyndactyly
oi!	oi
orgasmatic	orgasmic
ophiostomatoid	ophiostomatalean
overimprisonment	overincarceration
organoarsenical	organoarsenic
oxobutanoic	acetoacetic
oculometrics	oculometry
orgasmical	orgasmic
oculated	oculate
Osler-Rendu-Weber disease	Osler-Weber-Rendu disease
ovovivipary	ovoviviparity
ocean floor	seabed
overbored	overbore
ow	ouch
off-road bike	trail bike
ogac	Greenland cod
oblique dash	slash
officer of the peace	peace officer}}
O'Neill colony	O'Neill cylinder
oppressionism	oppression
oxazone	oxazinone
osteoarthrotic	osteoarthritic
outhauler	outhaul
oligospermatism	oligospermia
oligoelement	trace element
oftentime	frequent
online banking	e-banking
oxybarbituric	barbituric
overhail	overhaul
oblique subject	quirky subject
obfusticate	obfuscate
Oriental radish	daikon
oilseed radish	daikon
orchidalgia	orchialgia
osteopathologic	osteopathological
Ossetic	Ossetian
ornithopodan	ornithopod
olfactant	odorant
ovigenic	oogenetic
ontogenetically	ontogenically
obligative	obligatory
oboe-player	oboeist
other end	anus
onychodont	onychodontid
official scorer	scorekeeper
onomatopoetic	onomatopoeic
oxosteroid	ketosteroid
oxylance	oxygen lance
Okinawan yam	Okinawan sweet potato
oligocellosaccharide	cellodextrin
oleanolic acid	oleanonic acid
oleosome	spherosome
ophistotic	epiotic
opepe	bilinga
one card shy of a full deck	a few cards shy of a full deck
orchiotomy	orchidotomy
onychitis	onychia
old-maidhood	old-maidism
over and done	over and done with
oblique	slash
orthopter	ornithopter
of course my horse	of course
other fishes in the sea	other fish in the sea
oxethazaine	oxetacaine
oxoproline	pyroglutamic acid
onion flute	eunuch flute
off-road	off-street
old man	southernwood
ovigenesis	oogenesis
osmoregulant	osmoregulator
oogruk	bearded seal
ovogenesis	oogenesis
obinutuzumab	afutuzumab
oui	yes
oil swishing	oil pulling
odynometer	algometer
old-timer's disease	Alzheimer's Disease}}
onomatomancy	onomancy
oxgate	oxgang
opobalsamum	opobalsam
oxacyclopropane	ethylene oxide
octylaldehyde	octanal
ostreophage	ostreophagist
oikos	kontakion
overperson	overman
oblique mark	slash
oxoadipate	ketoadipate
oenophily	oenophilia
supersusceptibility	hypersusceptibility
steering wheel spinner	steering wheel spinner knob}}
supraparamagnetic	superparamagnetic
slipper spoon	shoehorn
spin button	spinner
schav	sorrel
synharmonic vowel	echo vowel
sarcode	protoplasm
stock symbol	stock ticker symbol
statutory heir	heir-at-law}}
sunbrella	parasol}}
speechless	unspeakable
sakes alive	land sakes
stop order	stop loss order
serostrain	serovar
sponge toffee	honeycomb toffee
systemic exertion intolerance disease	chronic fatigue syndrome}}
stuffed toy	soft toy
Spearman's rho	Spearman's rank correlation coefficient
sex doll	love doll
supramicrosurgery	supermicrosurgery
slipshoddiness	slipshodness
secondary healthcare	secondary care
singkamas	jicama
scandicain	mepivacaine
sunchair	sunlounger
strophiolated	strophiolate
support dog	service dog
seroperitoneum	hydroperitoneum
serrawettin	serratamolide
slideglass	microscope slide
skinnies	skinny jeans
sushi-go-round	sushi train
spiderwood	neinei
sea bread	hardtack
sauba	sauba ant
synonymics	synonymy
shock therapy	electroconvulsive therapy
star shower	meteor shower
soteriologic	soteriological
solifugid	camel spider
solvatization	solvation
steel drummer	pannist
scheduled	schedulee
saddle oyster	jingle shell
saccharidase	invertase
sulfourea	thiourea
scaleweed	pennycress
standard dialect	standard language
stingless nettle	fen nettle
syntenous	syntenic
slime eel	hagfish
semicastration	hemicastration
superinformation highway	information superhighway
superoxidase	superoxide dismutase
southernwort	southernwood
stretch limousine	stretch limo}}
suggestopedy	suggestopedia
Scots elm	wych-elm
sea dollar	sand dollar
strange fish	odd fish
stateman	statesman
slash print	scratch print
solifuge	camel spider
striatosome	striosome
shepherd tree	motlopi
ship rat	black rat
specifical	specific
Shannon capacity	Shannon limit
side mirror	wing mirror
sedimentologic	sedimentological
slap print	scratch print
scatter gun	shotgun
simnel	simnel cake
suprasaturation	supersaturation
stander by	bystander
stuck twin syndrome	twin-to-twin transfusion syndrome
suprafamily	superfamily
semidominance	incomplete dominance
stock prod	cattle prod
satyr	faun
semenarche	spermarche
socialistical	socialistic
stuffy	stuffed toy
spinal board	spine board
scribbleomania	scribblemania
supermanipulative	hypermanipulative
scrub board	rubboard
singles	tubulars
scrubwood	gumwood
science oven	microwave oven}}
scienceman	scientist
specific contract	nominate contract}}
swing saw	pendulum saw
seismometrical	seismometric
shit-eating smile	shit-eating grin
sapiency	sapience
scatter-gun	shotgun
store-bought	shop-bought}}
sun spider	camel spider
save appearances	keep up appearances
synurophycean	synurid
Soon™	soon}}
sleigh bell	jingle bell
ski skating	skate skiing
sweepstakes	sweepstake
SSI income	SSI
spondoolies	spondulicks
sex boycott	sex strike
standard star	reference star
stain lifter	stain remover
sawdust circuit	sawdust trail
superspreading	superwetting
systemical	systemic
stovepipe trousers	skinny jeans
salespersonship	salesmanship
Sabahian	Sabahan
stovepipes	stovepipe trousers
standard variety	standard language
subtle body	astral body
supracomplex	supercomplex
sweat like a horse	sweat like a pig
Semon's roundleaf bat	Semon's leaf-nosed bat
stone-lily	encrinite
shinrimei radish	shinrimei
schizoidal	schizoid
snap bracelet	slap bracelet
semestral	biannual
sexistic	sexist
separatrix	decimal point
stereovillar	stereocilial
synkinesia	synkinesis
self-pub	self-publish
schizocoel	pseudocoel
subluxed	subluxated
saponificated	saponified
stately home	country house
superprotective	overprotective
slasher flick	slasher movie
semibiotrophic	hemibiotrophic
submoon	moonmoon}}
shaving bump	razor bump
superexpression	overexpression
superestimate	overestimate
stoner metal	stoner rock
swagsman	swagman
shaft encoder	rotary encoder
steel drum	steelpan
second-class value	second-class object
superbenzene	coronene}}
sabayon	zabaglione
supramassive	supermassive
sweet bay	true laurel
santhara	sallekhana
subcovering	subcover
stentorophonic	stentorian
standerwort	standergrass
spectrographical	spectrographic
subculturist	subculturalist
subpseudopodium	subpseudopod
spermatocidal	spermicidal
snooperscope	sniperscope
Shelby knot	Pratt knot
synorchidism	synorchism
snowgo	snowmobile
sound bite	sound clip
shits-and-giggles	kicks-and-giggles
sweep something under the carpet	sweep something under the rug
stygobite	stygobiont
serja	sarinda
second-class citizen	second-class object
support ticket system	issue tracking system
spruce hen	spruce grouse
sauce boat	gravy boat
soccer football	soccer ball}}
soycheese	tofu}}
skil	sablefish
Sabellic	Sabellian
superemphasis	overemphasis
Spanish guitar	Baroque guitar
sealwort	Solomon's seal
stopcheck	checkstop
subcantor	succentor
solar cross	sun cross
survival bias	survivorship bias
special sauce	secret sauce}}
southermost	southernmost
sulfur-bottom whale	blue whale
Shetlandish	Shetlandic
swear like a sailor	swear like a trooper
secret sauce	special sauce}}
spokesfolks	spokespeople
scatoscopy	scatomancy
stereoisoform	stereoisomer
sphenoidal	sphenoid
swing loan	bridge loan
synepitheliochorial	epitheliochorial
spelling mistake	misspelling
staphylotome	uvulatome
Seleucian	Seleucid
separin	separase
southly	southerly
sex tool	sex toy
scientician	scientist
stellar nova	nova
spectrometrical	spectrometric
spermatotheca	spermatheca
space-time crystal	time crystal
spermiduct	vas deferens
southern screamer	crested screamer
spirotrichean	spirotrich
semizygous	hemizygous
scratch comma	slash
sinoacutine	salutaridine
Soxhlet apparatus	Soxhlet extractor
sunchoke	Jerusalem artichoke}}
sanguinously	sanguinely
skiblade	snowblade
subtilopeptidase	subtilisin
stand out a mile	stick out a mile}}
soul bell	passing bell
secondary forest	second-growth forest
set one's shoulder to the wheel	put one's shoulder to the wheel
Stein-Leventhal syndrome	polycystic ovary syndrome}}
stylus	style
scratch below the surface	scratch beneath the surface
scariole	endive
silyllithium	lithiosilane
semicellulose	hemicellulose
sure bet	safe bet}}
surgeonship	surgeoncy
Sanskritologist	Sanskritist
sleep like a dog	sleep like a log
shelf fungus	bracket fungus
sex labourer	sex worker
snuffers	snuffer
shoe verb	boot verb
scissorbill	razorback
short-arse	midget
sajiki-seki	masu-seki
shikonin	alkannin
simlin	simnel cake
sorbierite	sorbitol
sports bib	bib
self-conception	self-concept
snowy	snowy owl
subdiffractional	subdiffraction
side-swipe	sideswipe
shandry	shandrydan
sorcerer's stone	philosopher's stone}}
schizomer	restriction enzyme
status constructus	construct state
soul blues	soul-blues
sight rhyme	eye rhyme
seigneuress	seigneuresse}}
straight engine	in-line engine
Sicilian necktie	Colombian necktie
solvings	solutions
surexpression	overexpression
scatter band	scramble band
spermatist	spermist
sheeptrack	terracette
subspheroid	subspherical
simsim	sesame
Semiticism	Semitism
switching function	Boolean function
seismatic	seismic
strapping tape	filament tape
subject case	subjective case
snub post	snubbing post
siderographer	siderographist
shit eye	stink eye
sodium glutamate	monosodium glutamate
suicide special	Saturday-night special
scleromorphic	sclerophyllous
stické	sphairistike
sawbench	table saw
skating technique	skating}}
slash mark	slash
scolymoside	veronicastroside
squirrel wheel	squirrel cage
staminody	staminode
sugar paper	construction paper
Swedenborgianist	Swedenborgian
synurban	synurbic
small miracle	minor miracle
spunkish	spunky
snow bike	skibike}}
superbackground	superspace
Scoville unit	Scoville heat unit
sub-moon	moonmoon}}
shawmer	shawmist
Sippenhaftung	Sippenhaft
steatohepatosis	fatty liver
synergistical	synergistic
sportwear	sportswear
side drum	snare drum
Schrammel guitar	contraguitar
shilling mark	slash
sheet silicate	phyllosilicate
Scotch boiler	Scotch marine boiler
sulfonamidine	sulfonodiimidamide
shielded cable	screened cable
Sarmatianism	Sarmatism
sunset years	twilight years
seismographical	seismographic
spike	endpin
speech tag	dialogue tag
schematical	schematic
sizzle steak	chipsteak
supraselective	superselective
squeeze box	hug machine
sinistrorotatory	levorotatory
subsquamosal	subsquamous
sericiculture	sericulture
sunshine and lollipops	sunshine and rainbows
splitwork	splintwork
scarce as hen's teeth	rare as hen's teeth
shit beetle	dung beetle
southern	southerner
superacoustic	supersonic
seafood fork	fish fork
sphragis	sphragide
sew-ups	tubulars
spherocrystal	spherite
smoothbored	smoothbore
San Joaquin fever	San Joaquin Valley fever
serosanguinolent	serosanguineous
subtype polymorphism	subtyping
sodomitry	sodomy
shit distributer	shit disturber
Suecophile	Swedophile
self-suggestion	autosuggestion
sandspur	sandbur
Spanish fever	Texas fever
sausage factory	sausage party}}
sastrugus	sastruga}}
spelling error	misspelling
smooth mudalia	smooth rocksnail
sended	sent
stage-stricken	stagestruck
sanitary pad	sanitary towel
suprabasilar	suprabasal
sardonical	sardonic
scatophagy	coprophagy
sheefish	inconnu
supergravitation	supergravity
steam piano	calliope
spirit world	spiritual world
screen dump	screenshot
Schmidt rearrangement	Schmidt reaction
sakabula	widow bird
stirrup strap	stirrup leather
screw top	screw cap
serpentarium	ophidiarium
solar spot	sunspot
surgical abdomen	acute abdomen
Seleucidan	Seleucid
suspensive condition	condition precedent}}
Swiss dot	dotted Swiss
surrogate proxy	reverse proxy
scriptura continua	scriptio continua
scatophagous	coprophagous
Sakurajima daikon	Sakurajima radish
stygobiont	stygobiotic
smallest common multiple	least common multiple
staticy	staticky
steel pannist	pannist
sulfidoleukotriene	cysteinyl leukotriene
strawperson	strawman
sociometrical	sociometric
snowblink	iceblink
Swiss cheese	Emmentaler}}
spermatocyst	spermatocele
swim trunks	swimming trunks}}
splatfest	splatterfest
subcuticle	hypodermis
sectarial	sectarian
shielding constant	screening constant
sacrouterine	uterosacral
stilbonematid	stilbonematin
speculator	field goal
stellar system	star system}}
solicitor-client privilege	attorney-client privilege
Shwachman-Bodian-Diamond syndrome	Shwachman-Diamond syndrome
South Caucasian	Kartvelian
strait and narrow	straight and narrow
slasher film	slasher movie
scientistical	scientistic
step on the gas	hit the gas
scuttlefish	cuttlefish}}
serpent gourd	snake gourd
spermiogram	semenogram
spinocerebral	cerebrospinal
spoon worm	echiuran
satelloon	balloon satellite
Sovietic	Soviet
salt of lemon	salt of sorrel
sylvine	sylvite
snuff movie	snuff film
spontaneous fission	nuclear fission
septicide	septicidal
steam organ	calliope
synexin	annexin
subflavour	undertaste
subordinate legislation	secondary legislation}}
smartassy	smartassed
screwjack	jackscrew
starvate	starve
stereoviewer	stereoscope
sangen	shamisen
sexagenary	sexagenarian
superinfluenza	superflu
selfpub	self-publish
special service request	special service requirement
silky soft	soft as silk
shit distributor	shit disturber
scaly clam	fluted giant clam
Sidetan	Sidetic
Salishist	Salishanist
sightless	invisible
spaling	spale
scolding stool	cucking stool
Sozi	social democrat
strudel	at sign
sakkie-sakkie	sokkie
sweet thirteen	bat mitzvah}}
swear on	swear upon
sole right	exclusive right
saddlebum	saddle tramp
silanyl	silyl
stellar month	sidereal month
sanctioneer	sanctioner
soft in the head	softheaded
samurai sword	katana}}
spermatangium	gametangium
spadicose	spadiceous
second-class entity	second-class object
synchondrotomy	symphysiotomy
stick a needle in my eye	cross my heart and hope to die
stank eye	stink eye
supersonication	ultrasonication
shoegaze	shoegazing
split switch	point switch
stop and frisk	stop-and-search
scarlet bean	scarlet runner
siciliano	siciliana
steel bronze	bronze steel
semicategory	semigroupoid
state enterprise	state-owned enterprise}}
self-deceit	self-deception
silent as the tomb	silent as the grave
storage engine	database engine
sulfenium	sulfenylium
sea legs	crab sticks
super middleweight	cruiserweight
slider	slide
Sybian	Sybian saddle
signaller	signalman
subsacristan	subsacrist
siege piece	obsidional coin
slantingways	slantwise
shoppertainment	retailtainment
spacecraft bus	satellite bus
sled hockey	sledge hockey}}
sanjakate	sanjak
septaemia	septicemia
saltwork	saltworks
systemize	systematize
suprajacent	superjacent
Swiss bank	Swiss bank account
Somalian	Somali
shota	shotakon
semisuffix	suffixoid
sprints	tubulars
shadow history	secret history
stratum germinativum	stratum basale
superterranean	aboveground
slant line	slash
see reason	see sense
splash-and-go	splash-and-dash}}
silicane	silane
saturated vapor pressure	saturation vapor pressure
spore fruit	ascocarp
skimmity-ride	charivari
stereometrical	stereometric
sow stall	gestation crate
sweet fifteen	quinceanera}}
speak in circles	talk in circles
swankish	swanky
Southern lady's slipper	Kentucky lady's slipper
sclerine	exine
smell trap	stench trap
scientific socialist	Marxist
stereovillum	stereocilium
scutigerous	scutiferous
satin stone	satin spar
StudlyCaps	UpperCamelCase
selectionistic	selectionist
spew alert	drink alert
splendidiferous	splendidious
shelf bra	balcony bra
senectude	senectitude
septamer	heptamer
seed bank	seed vault
sternopleuron	katepisternum
sportcaster	sportscaster
spectrophotofluorometer	spectrofluorophotometer
stroboscopical	stroboscopic
sericiculturist	sericulturist
sea mammal	marine mammal
solidus	slash
supragenome	pangenome
steer tube	steerer tube
stop-and-frisk	stop-and-search
siren call	siren song
submergible	submersible
squashed fly biscuit	fly biscuit
semiotical	semiotic
stick one's head in the sand	bury one's head in the sand
slim client	thin client
shotgun cloning	shotgun sequencing
subancipitous	subancipital
symmetrian	symmetrician
sans doute	without a doubt
saddle-bum	saddle tramp
sixty-four thousand dollar question	million-dollar question}}
slide-fire gunstock	bumpfire gunstock
swap places	change places
sardai	thandai
supermasculinity	hypermasculinity
supersusceptible	hypersusceptible
sinoauricular	sinoatrial
Scotch snap	Lombard rhythm
selfubiquitination	autoubiquitination
salpingian	salpingeal
Sierpinski cube	Sierpinski sponge
shed find	barn find
sabotageur	saboteur
synecdochic	synecdochical
Spanish tickler	cat's-paw
saddle bum	saddle tramp
secret shopper	mystery shopper
sequential art narrative	comic strip
sportscoat	sports jacket
storm in a teapot	tempest in a teapot}}
seal script	small seal script
scotcher	toppler
slugabug	slugabed}}
split wheel	split pulley
seasonal lake	intermittent lake
stomach ulcer	peptic ulcer
sparge	lautering
sharksfin	shark fin
stink trap	stench trap
shingleback	blue-tongued skink
spermaphytic	spermatophytic
scissors paper stone	rock paper scissors
see shit	see things
shepherd's tree	motlopi
scandalmonging	scandalmongering
short man syndrome	Napoleon complex
supraglenoidal	supraglenoid
styrofoam popcorn	packing peanuts
supermethylated	hypermethylated
siderochrome	siderophore
slant	slash
strangling angel	diphtheria}}
setline	trotline
sausage poisoning	allantiasis
serotypic	serotypical
spectre bat	spectral bat
scripta continua	scriptio continua
setting rule	composing rule
spheropolygon	spheropolyhedron
snowball's chance	snowball's chance in hell
secting	cutting
Semiticist	Semitist
stereoelective	enantioasymmetric‎
stasidion	kathisma
sheet pan	baking sheet
spacer DNA	intergenic spacer
stylometrician	stylometrist
schizomania	bipolar disorder
Strohviol	Stroh violin
storm in a teacup	tempest in a teapot
spoonways	spoonwise
slipshoddy	slipshod
symbolical	symbolic
subterrain	subterranean
Suzuki coupling	Suzuki reaction
scatologic	scatological
slash dupe	scratch print
secondary work	secondary source
skate around	skate over
sunskirter	sungrazer
sour honey	propolis}}
stromatoporid	stromatoporoid
silicaceous	siliceous
storm in a tea-kettle	tempest in a teapot}}
somaticism	somatic symptom disorder
Silk Road disease	Behçet's disease
sanky	sanky-panky
X-Day	D-Day}}
xeloda	capecitabine
xylazil	xylazine
xylovore	xylophage
Xbrick	Xbox
xenotransgraft	xenotransplant
xiphopagic	xiphopagus
xenomorphous	xenomorphic
xenosis	zoonosis
xionghuang wine	realgar wine
xeroxlore	photocopylore
xylacine	xylazine
X-radiation	X-ray radiation
burglarizer	burglar
bridle trail	bridle path
beard lichen	old man's beard
bismer	steelyard
bradyrhythmia	bradycardia
Babylonical	Babylonic
boob-sling	bra
boat shed	boathouse
balconette bra	balcony bra
bestestestestestest	best
Beijing duck	Peking duck
Bavarian hat	Tyrolean hat
bractea	bract
blow one's cork	pop one's cork
barochamber	hyperbaric chamber
biotherapic	biotherapeutic
bacteriovirus	bacteriophage
banjo dulcimer	dulcijo
becket bend	sheet bend
bucket of rust	rustbucket}}
bioballistics	biolistics
booster cable	jumper cable
banjo-mandolin	banjolin
butt burp	bottom burp
blue-throated goldentail	blue-throated sapphire
beginner's permit	learner's permit
booklore	book-learning
benzosulfimide	saccharin
bush-cricket	katydid
boiling-hot	boiling hot
behavioral psychology	behaviorism
bassooner	bassoonist
bottle whore	bottle rat
bottom-hat transform	black top-hat transform
beat into shape	whip into shape
bon viveur	bon vivant
bestestestest	best
Brocken spectre	mountain spectre
bumblebee bat	Kitti's hog-nosed bat
bilharziasis	schistosomiasis
bar crawl	pub crawl
black lead	graphite
bestestest	best
bum deal	raw deal
bioprospection	bioprospecting
baicai	bok choy
babbitt metal	babbitt
banjitar	guitjo
best-by date	best-before date
bat for the other side	bat for the other team
black people's time	African time
Beijing opera	Peking opera
biocrude	bio-oil
boob envy	breast envy
Blue	British Blue
biodeme	deme
belongness	belonginess
butt-munching	anilingus
Brunton	Brunton compass
bullshit bingo	buzzword bingo
bowed guitar	arpeggione
biangulate	biangular
bishydroxycoumarin	dicumarol
buprinex	buprenorphine
bolivianite	ametrine
badge of merit	merit badge
bioamplification	biomagnification}}
bellyboarding	bodyboarding
braguinha	cavaquinho
bridewealth	bride price
bean slot	bean chute
Beyer-Garratt	Garratt
Bali belly	Delhi belly
backspin	spinback
brauche	braucherei
bubble boy syndrome	bubble boy disease
bloodflow	bloodstream
brotherly love	agape
big deuce	big two}}
bone-mouth	shar-pei
brayera	kousso
banjo ukulele	banjolele
boob reduction	breast reduction
buttkisser	kiss-ass
benzopinacone	benzopinacol
Brexiter	Brexiteer
banate	banat
boot upstairs	kick upstairs
box standard	standard
bleeding hell	bloody hell
binge viewing	binge watching
bongkrekic acid	bongkrek acid
biomonitorization	biomonitoring
biscarbonate	dicarbonate
businessman's special	businessman's trip
bahooey	hooey
Braxton Hicks	Braxton Hicks contraction
boodlery	boodlerism
binding agent	binder
blind as a beetle	blind as a bat
baby carrier	child carrier
basidiome	basidiocarp
bastard camphor tree	Cape quince}}
brain worker	knowledge worker
bisperoxovanadium	bisperoxovanadate
bride token	bride price
bride-gift	bride price
boofish	daft
balsam of Gilead	balm of Gilead
babieswear	babywear
bradykininogen	kallidin
black bag job	black bag operation
blue code	blue wall of silence
brotherfucking	motherfucking
body worn video	body camera
back and forward	back and forth
Brahminy duck	ruddy shelduck
bitpacked	bit-compressed
beed	were
blow out of proportions	blow out of proportion
brittle bone disease	osteogenesis imperfecta
Bisbee turquoise	Bisbee blue
benzodioxolane	benzodioxole
biomimesis	biomimicry
biocremation	resomation
bàtá	bata
biological fuel cell	microbial fuel cell
booblike	breastlike
baby bouzouki	baglamas
brigandry	brigandage
Brownian movement	Brownian motion}}
benzanthrene	benzanthracene
baji	chiura
bodymass	bodyweight
blood sibling	blood brother
Berlin breakage syndrome	Nijmegen breakage syndrome
biomimic	biomimetic
bow harp	arched harp
blue code of silence	blue wall of silence
blank sheet	blank canvas
bronchiae	bronchia
butylic	butyl
butternut pumpkin	butternut squash
Brabantine	Brabantian
boob cancer	breast cancer
bride wealth	bride price
bed of down	bed of roses
bisphosphatidylglycerol	cardiolipin
bottle-sickness	bottle-shock
bathyorographic	bathyorographical
bathymodiolid	bathymodiolin
Buckley syndrome	hyperimmunoglobulin E syndrome
bump-start	push-start
brolly dolly	grid girl
bug bomb	aerosol bomb
ball pond	ball pit
buxotic	busty
box joint	finger joint
businessman's lunch	businessman's trip
blow with the wind	go with the flow
bathycolpous	bathykolpian
battening	batten
butcher's hook	butcher's
bradyphasia	bradylalia
Bronx cheer	raspberry
biggererer	bigger
bargain bucket	bargain bin
Bohm interpretation	Bohmian mechanics}}
braguinho	cavaquinho
bionergy	bioenergy
built like a shit brickhouse	built like a brick shithouse
barklouse	booklouse
bastard coolibah	gum coolibah}}
bush rat	rock rat
butter-and-egger	butter-and-egg man
bee up one's ass	bee in one's bonnet
bastion forest	red forest
babanriga	agbada
bradyglossia	bradyarthria
bar graph	bar chart
beauty heart radish	watermelon radish
bugle-player	bugler
bridegift	bride price
bike motocross	BMX}}
brown crab	edible crab
biggerer	bigger
bovine infectious petechial fever	petechial fever
boronatrocalcite	ulexite
bidispersed	bidisperse
bad loser	sore loser
ballistoconidium	ballistospore
bride-wealth	bride price
Baltimore finch	Baltimore oriole
bounce house	bouncing castle
biodetector	biosensor
bioastronomer	astrobiologist
benzeneamine	toluene
biosociology	sociobiology
booty bass	Miami bass
butcher's steak	hanger steak}}
baseplate	tie plate
blind as a mole	blind as a bat
Biskara boil	Aleppo boil
back oneself into a corner	paint oneself into a corner
bum burp	bottom burp
barbulate	barbellate
Bhattacharyya distance	Hellinger distance
biotinyllysine	biocytin
Baltimore	Baltimore oriole
brachycardia	bradycardia
boob augmentation	breast augmentation
borhyaenoid	borhyaenid
bummed	bummed out
blank page	blank canvas
bench-hole	lavatory
bluegrass jazz	bluegrass-jazz
bush song	bush ballad
biharmonical	biharmonic
bodhisat	bodhisattva
boneworm	bone-eating snot flower worm
blind as an owl	blind as a bat
blow it out one's ear	blow it out one's ass
brevirostrine	brevirostral
Big Mac sauce	burger sauce}}
balconette	balcony bra
bradylogia	bradyarthria
bettererer	better
black finger crab	reef crab
book knowledge	book-learning
bouncy castle	bouncing castle
blood smear	blood film
bioastronomy	astrobiology
bulbosacral	parasympathetic
boardercross	snowboard cross}}
baglamadaki	baglamas
bursage	burrobrush
bucket of sunshine	barrel of sunshine
blooming hell	bloody hell
badassed	badass
boobfeeding	breastfeeding
batholite	batholith
barftastic	disgusting
beetroot	beet
butyrocholinesterase	pseudocholinesterase
bovine petechial fever	petechial fever
buster collar	Elizabethan collar
bicycle motocross	BMX}}
bravity	braveness
basipod	basipodite
ball pool	ball pit
bovate	oxgang
bunny grass	Easter grass
basioccipital	basiocciput
binoid	bimonoid
batá	bata
brûlée	crème brûlée
bastard sandalwood	false sandalwood
brassic acid	docosadienoic acid
beat the tar out of	beat the stuffing out of
bosonification	bosonization
bride gift	bride price
backstretch	back straight
bioderv	biodiesel
beach umbrella	parasol
biscarbamate	dicarbamate
Bobbitt procedure	emasculation
boat-shaped abdomen	scaphoid abdomen
bidactyly	didactyly
breakaway glass	sugar glass
boob implant	breast implant
Babbitt metal	babbitt
boy-cut	boyleg
barbituratism	barbiturism
battery-operated	battery-powered
behavioural psychology	behaviorism
bestestestestest	best
bubble baby disease	bubble boy disease
be it what it would	regardless
biocycle	biorhythm
bacterial wetwood	slime flux
bioeconomical	bioeconomic
Bragg mirror	dielectric mirror
build upon	build on
biofermentation	fermentation
beef-brained	beef-witted
bipyrazyl	bipyrazine
book steak	flat iron steak
bichromate	dichromate
Bristol	Bristol board
Burmese snub-nosed monkey	Myanmar snub-nosed monkey
bronchoconstricting	bronchoconstrictive
Babbitt's metal	babbitt
boleadora	bolas
blowing mill	blowing house
bloom tea	hyson skin
bread wheat	common wheat
beach buggy	dune buggy
banjolin	banjo-mandolin
blindered	blinkered
bradree	baradari
biodisponibility	bioavailability
blockorama	blocko
bolaform	bolaamphiphile
Bologna sausage	bologna
bilaplacian	biharmonic
beginner's license	learner's permit
brachyuranic	brachyuran
bistropha	distropha
boudoir piano	upright piano
bokke	sea raven
bee bite	bee sting
bohr	Bohr radius
bell hopper	bellhop}}
banjo uke	banjolele
booty shorts	boyshorts
battleship curve	battleship-shaped curve
berkut	golden eagle
bloodfeeding	hematophagy
boss button	boss key
biking shorts	cycling shorts
bisphosphorylated	diphosphorylated
barony	hundred
bilipidic	bilipid
biocharacteristic	biocharacter
bromosulfalein	bromsulphthalein
blow one's stack	blow one's top
breathe one's last breath	breathe one's last}}
buttass	very
bypoll	by-election
boilerplate code	boilerplate
bakestone	Welshcake
big dumper	dump truck
bilobulate	bilobular
bisepoxide	diepoxide
butler's pantry	serving pantry
banthine	methantheline
backflash	flashback
blammo	whammo
bonnet snail	helmet snail
billsticking	billposting
butler steak	flat iron steak
bursacyte	B cell
butt stuff	anal sex
bat ear	otapostasis
bureaucratical	bureaucratic
Behçet's syndrome	Behçet's disease
bistellar flip	Pachner move
blow-organ	melodica
bet a dollar to a dime	bet a dollar to a doughnut
borsholder	tithingman
bicyclam	plerixafor
beta-lipoprotein	low-density lipoprotein
brachygnathia	micrognathism
bargander	shelduck
beautism	lookism
biose	disaccharide
blorch	con crud
bare-boobed	bare-breasted
biphosphorylated	diphosphorylated
badassitude	badassery
beep test	bleep test
banyalla	waddywood
commandlet	cmdlet
cerebropathia	encephalopathy
caproaldehyde	hexanal
carbomonoxyhemoglobin	carboxyhemoglobin
Corinthian brass	Corinthian bronze
curb weight	kerb weight
cerotinic acid	cerotic acid
conductor rail	third rail
chromene	benzopyran
chalkitis	chalcosis
Colorado River toad	Sonoran Desert toad
chitarrone	theorbo
chain silicate	inosilicate
cerebrocuprein	erythrocuprein
cinchol	sitosterol
chemotherapeutical	chemotherapeutic
Culver's physic	Culver's root
choir screen	rood screen
chemorefractive	chemorefractory
come down the road	come down the pike
consciencism	Nkrumaism
chromatographical	chromatographic
chalcographist	chalcographer
celestial stem	heavenly stem
camping site	campsite
cyclectomy	ciliectomy
chuck one's toys out of the cot	throw one's toys out of the pram
comfort letter	letter of comfort
camping ground	campground
cytoguardin	methoxytryptophan
call in the wilderness	voice in the wilderness
conia	coniine
confrontationalist	confrontationist
common crossbill	red crossbill
control pad	d-pad
coprosterol	coprostanol
cat lady	spinster
coccygodynia	coccydynia}}
cycle shorts	cycling shorts
cymophenol	carvacrol
chemicophysical	physicochemical
Chinese mushroom	shiitake}}
Chinese white radish	Chinese radish
colloidoclastic	anaphylaxic
cerebromeningitis	meningoencephalitis
complement	alexin
chronologic	chronological
craniostenosis	craniosynostosis
cyclopentanoic acid	cyclopentanecarboxylic acid
chelem	slam
comma-point	comma
countrypolitan	Nashville sound
cunning linguistics	cunnilingus
cigar beetle	cigarette beetle
chrestomathical	chrestomathic
country gravy	sawmill gravy
capryl	octyl
chastity ring	purity ring
cytohistologic	cytohistological
camsylate	camphorsulfonate
Cfu	CFU
catch on fire	catch fire
conjunctiveness	conjunctivity
coulochemical	electrochemical
connotive	connotative
cumulostratus	stratocumulus
counterpuncture	counteropening
chain case	gear case
curd cheese	cottage cheese
curmudgeonous	curmudgeonly
criteriological	criteriologic
Conestoga wain	Conestoga wagon
chafe at the bit	champ at the bit}}
cholelithotrity	cholelithotripsy
curetment	curettage
cradle crust	cradle cap
chikoo	sapodilla
choreomania	tarantism
cloaks	cloakroom
come from the right place	come from a good place
cry buckets	weep buckets}}
compunication	compunications
crab oil	carap oil
carbobenzoxy	benzyloxycarbonyl
cogenial	congenial
cunt muncher	lesbian
cerebroma	encephaloma
court roll	manorial roll
cabinet piano	upright piano
cyberformance	cyberperformance
colimycin	colistin
calspectin	fodrin
counter-internationalism	anti-internationalism
counter-imperialism	anti-imperialism
confrontationalism	confrontationism
cry in the wilderness	voice in the wilderness
Comstockism	comstockery
cheeky yam	air potato
chardonnay socialist	champagne socialist
catmint	catnip
choleic	biliary
counted cross-stitch	cross-stitch
cello player	cellist
catastrophic forgetting	catastrophic interference
cryptocoin	cryptocurrency
compensated dating	enjo kosai
cyclone pit	cyclone cellar
captain's walk	widow's walk
carpenter's hat	printer's hat
cementification	cementogenesis
Croatian chessboard	Croatian checkerboard
calcium dioxide	calcium peroxide
casting net	cast net
chimneysweeper	chimney sweep
corpse hounds	Gabriel's hounds
coffee ground vomitus	coffee ground vomiting
chloroperoxidase	chloride peroxidase
cinder toffee	honeycomb toffee
catstep	terracette
clinoscope	clinometer
chronogrammatical	chronogrammatic
colloidosmotic	oncotic
chemoattractor	chemoattractant
cobaltine	cobaltite
centralized planning	central planning
carpet rod	stair rod
catoecic	cleruchic
cephalomeningitis	meningitis
cerotinic	cerotic
cytocentrum	centrosome
common lobster	European lobster
cacodemonia	cacodemonomania
cocktail cabinet	cocktail table
corpspeak	corporatespeak
Crookes layer	Crookes space
cytodendrite	dendrite
crawl before you can walk	crawl before you walk
cataclysmical	cataclysmic
chlorophenothane	dichlorodiphenyltrichloroethane
comedical	comedic
cowardness	cowardice
caprinaldehyde	decanal
chondre	chondrule
cavex rake	thatch rake
chew the rag	chew the fat
cupping jar	cupping glass
chitosamine	glucosamine
cream one's jeans	cream in one's jeans
comb joint	finger joint
cross the river	pass the river
cyanoplast	cyanelle
carbamoyltransferase	transcarbamoylase
cytophagocytosis	cytophagy
copylore	photocopylore
cyclamic	cyclohexylsulfamic
chicozapote	sapodilla
carboxycyanine	carbocyanine
cyclohexatriene	benzene}}
capellini	angel hair
corticography	electrocorticography
cat that got the cream	cat that ate the canary
clevosaurid	clevosaur
commercial at	at sign
crawler track	caterpillar
cevadine	veratrine
coumadin	warfarin
circumbenzene	coronene}}
charangoist	charanguista
clean electricity	clean power
cuddly toy	soft toy
corbiculum	corbicula
cha-cha-cha	cha-cha
chaise lounge	chaise longue
corn snow	corn
conular	conical
citronyl	citren
complify	complicate
cinnamon bun	cinnamon roll
Creolity	Creoleness
cha cha	cha-cha
cellose	cellobiose
conch	concher
configurally	configurationally
ceratoglossus	chondroglossus
cyclicalism	cyclicism
Copernicanist	Copernican
chlorohemin	hemin
Colored People Time	CP Time
clava	gracile tubercle
cholic acid	bile acid
congiaria	congiary
criterion of verifiability	verifiability principle
cetylstearyl	cetostearyl
caloric	calorific
coenobitical	cenobitic
clinical biochemistry	clinical chemistry
chronospatial	spatiotemporal
cancerogen	carcinogen
cytopempsis	transcytosis
country-rock	country rock
code-mixing	code-switching
centrifugalization	centrifugation
cetearyl	cetostearyl
counterflowered	counterflory
cardiologic	cardiological
curly-braces language	curly-bracket language
collaborative economy	sharing economy
could care fewer	could care less
cycloduction	circumduction
caveat loan	bridge loan
corton	creton}}
calamansi	calamondin
come down the line	come down the pike
content warning	trigger warning
ciminite	arsoite
collagen disease	collagenosis
climatographical	climatographic
centroheliozoan	centrohelid
coatomic	coatomistic
cha cha cha	cha-cha
cassata	cassata siciliana
cocompound	dvandva
conformistic	conformist
carillonneur	carillonist
coniferaldehyde	coniferyl aldehyde
Croatian chequy	Croatian checkerboard
cation-pi	cation-π
curly-brace language	curly-bracket language
chromocentre	karyosome
coadministrate	coadminister
chorionation	choriogenesis
chiguire	capybara
Croatianize	Croatize
carbonmonoxyhemoglobin	carboxyhemoglobin
chondrosis	chondrogenesis
carboanhydrase	carbonic anhydrase
come-outism	come-outerism
carbamidine	guanidine
cisgendered	cisgender
columnary	columnar
cardiotherapeutics	cardiotherapy
cryptomarket	darknet market
capelli d'angelo	angel hair
circular function	trigonometric function
chronotropy	chronotropism
common rush	soft rush
centrifugalize	centrifugate
cane beardgrass	cane bluestem
co-op	cooperate
cattle goad	cattle prod
comma of Didymus	syntonic comma
champagne soda	champagne cola
clitoric	clitoral
cytokaryomegaly	karyomegaly
calibrable	calibratable
cittosis	pica
crotchbulge	manbulge
ceil function	ceiling function
cyclohexanoic acid	cyclohexanecarboxylic acid
Chunqiu	Spring and Autumn
caloricist	calorist
Central Asian shepherd dog	Central Asian Ovcharka
canegrass	love grass
carcinosomatoid	carcinosomatid
cichorigenin	aesculetin
cheer to the echo	applaud to the echo
chillout	downtempo
coxcombic	coxcombical
capistrum	phorbeia
common millet	pearl millet
cytodieresis	cytokinesis
clasmatocyte	macrophage
capesized	Capesize
coin flip	coin toss
corporativism	corporatism
chloroanaemia	chlorosis
Charlie Brown Christmas tree	Charlie Brown tree
calcifugous	calcifugal
carbaprostaglandin	carbacyclin
charter court	constitutional court}}
cyanidol	catechol
chromatinolysis	chromatolysis
cytarabinoside	cytarabine
cassena	dahoon
courier bag	messenger bag
corporativist	corporatist
cube-square law	square-cube law
curbside service	curb service
coccidium	coccidian
cassinoid	Cassini oval
cevitamic acid	ascorbic acid
catwort	catnip
cryoprotector	cryoprotectant
collutorium	mouth wash
cumulonimbus tuba	funnel cloud
carboxyamidomethylation	carbamidomethylation
cyberathletics	e-sports
carboxydismutase	rubisco
cranic	cranial
cybernetical	cybernetic
cymatoscope	cymoscope
close borough	pocket borough
codeia	codeine
ceporex	cefalexin
calcino	muscardine
colon-point	colon
complex compound	coordination compound
cytolysosome	autophagosome
chinic acid	quinic acid
criterion of verification	verifiability principle
cytospinner	cytospin
catabolin	interleukin
chopette	choplet
cilioskeleton	axoneme
countercolored	counterchanged
Chinese radish	daikon
choleratoxin	choleragen
cozymase	nicotinamide adenine dinucleotide
cytozyme	thromboplastin
coumaranone	benzofuranone
concert spiritual	spiritual
capronate	hexanoate
camiknicker	camiknickers
commonsensible	commonsensical
climate denial	climate denialism
calcaneovalgus	clubfoot
cementstone	calcilutite
C-section	Caesarean section
chachacha	cha-cha
cognate object	cognate accusative
code of silence	wall of silence
caseate	caseinate
chemovar	chemotype
coffee machine	coffeemaker
chondrocostal	costochondral
calorific rays	infrared radiation}}
chromolipid	lipochrome
Chinese green	lokao
continuing education	further education
cylinder mower	reel mower
cholesterinosis	cholesterolosis
civil day	calendar day
cocurriculum	extracurriculum
choroidosis	choroidopathy
centralistic	centralist
crystalline arthritis	gout
crassinucellar	crassinucellate
campylotropal	campylotropous
cold allergy	cold urticaria}}
cronynomics	crony capitalism}}
cut swathes	cut a wide swath
cardinal direction	cardinal point
cherry on the cake	icing on the cake
chemospecific	chemoselective
cingulectomy	cingulotomy
Chinese Crested	Chinese Crested Dog}}
checkermallow	checkerbloom
chao tai D	big deuce/big two}}
cruise liner	cruise ship
calcaneovarus	clubfoot
cryopedoturbation	cryoturbation
cacographical	cacographic
chachachá	cha-cha
chat show	talk show
countercorrelation	anticorrelation
Chinese green radish	watermelon radish
china marker	china pencil
chlorazene	chloramine
combativity	combativeness
cow weed	cowbane}}
chromistan	chromist
counterinvestment	countercathexis
cornicyll	pibgorn
cyclopic	cyclopean
connected at the hip	joined at the hip
chicken pest	Newcastle disease
cystopyelitis	pyelocystitis
custard slice	vanilla slice
carboheterocyclic	heterocyclic
coenocyst	coenocyte
cilexetil	candesartan
commonsensibly	commonsensically
crib sheet	cheat sheet
combustion triangle	fire triangle}}
coprophagist	coprophage
cystous	cystic
Chinese cassia	Chinese cinnamon
calcipenia	hypocalcaemia
chalcolithic	Eneolithic
correus	correus debendi
cyclical vomiting syndrome	cyclic vomiting syndrome
costophrenic	phrenicocostal
combinatorician	combinatorist
cuticlin	cuticulin
carbol	carbolic acid
ciproxin	ciprofloxacin
colpectomy	vaginectomy
Cuban sweet potato	boniato
crank	methamphetamine
clientism	clientitis
chromatometer	colorimeter
chucker-out	bouncer
cevitamic	ascorbic
clitoridean	clitoral
cotransportation	cotransport
crosslinking	crosslinkage
christianite	phillipsite
cattywampus	cater-corner
carbostesin	bupivacaine
carbogenated	carbonated
chymosinogen	prochymosin
cornworm	corn earworm
counterlawsuit	countersuit
chokecoil	choking coil
car wreck	car crash
cephalodynia	headache
Che Guevarist	Guevarist
cyclomatic number	circuit rank
chicken gun	chicken cannon
cancerigenic	carcinogenic
cuminal	cuminaldehyde
chromista	chromist
Cornish hen	Cornish game hen
cerebromedullar	cerebromedullary
calcide	alkaline earth metal
calliaphone	calliope
coemployee	coworker
cytophil	cytophilic
chinic	quinic
clinometrical	clinometric
croceate	croceous
chuckwagon beans	cowboy beans
cotton wool ball	cotton ball
chirky	chirk
cfu	CFU
cataphonics	catacoustics
compensation balance	compensation pendulum
considerate	consider
Chinese food syndrome	Chinese restaurant syndrome
chhole	chana
cardware	postcardware
catslide	catslide roof
centurion's staff	vine staff
composition notebook	composition book
counterindicate	contraindicate
chloruria	chloruresis
cap of liberty	liberty cap
China ink	Indian ink
cardionatrin	atriopeptin
cryoanalgesia	cryoneurolysis
curly brace	curly bracket
continuation day	contango day
Chinese sausage	lap cheong}}
companion set	fireside set
coccyalgia	coccydynia
creology	creolistics
codeathon	hackathon
chromonar	carbocromen
corn mother	corn dolly
Charlie Brown's Christmas tree	Charlie Brown tree
colorectoscopic	proctoscopic
coradical	socle
Cohenistic	Cohenist
coccal	coccic
confoundation	confoundment
counterrevolutionist	counterrevolutionary
chrysomonad	chrysophyte
cloud number nine	cloud nine
California pizza	California-style pizza
coixseed	Job's tears
curved edge	bent edge
cardiogenin	scillarenin
chest one's cards	keep one's cards close to one's chest
Canadian violet	Canada violet
corticosterol	hydrocortisone
crested hawk-eagle	changeable hawk-eagle
conditional baptism	hypothetical baptism
cryptocyanin	cryptocyanine
cephalorachidian	cerebrospinal
close-up lens	macro lens
conveyal	conveyance
contradictorial	contradictory
cocyclic	concyclic
colloxylin	pyroxylin
chemotaxonomical	chemotaxonomic
cycliophore	cycliophoran
chainsticks	nunchaku
Chinese grapefruit	pomelo
cannabionoid	cannabinoid
carbasugar	sugar alcohol
conche	concher
circumintestinal	perienteric
chapel cart	Whitechapel cart
calculosis	lithiasis
caroller	caroler
cyberetiquette	netiquette
counterregulative	counterregulatory
car body	auto body
catapleurite	coxopleurite
carcinous	carcinomatous
cyanoferrate	ferricyanide
California stop	rolling stop
contract programming	design by contract
connatal	congenital
combinatoricist	combinatorist
casual Friday	dress-down Friday
clamoxyl	amoxicillin
cineroentgenography	cineradiography
clausal normal form	conjunctive normal form
chemotactant	chemotactic
capitalistical	capitalistic
caerulin	ceruletide
costocentral	costovertebral
calichon	mandora
copalite	copaline
cosmologic	cosmological
conspiracy hypothesis	conspiracy theory
crusta lactea	cradle cap
crown clade	crown group
colistimethate	colistin
chavness	chavviness
command economy	planned economy
conicine	coniine
celloist	cellist
cingulumotomy	cingulotomy
conic	conical
consecutive interpreting	consecutive interpretation
coccous	coccic
calcaneoscaphoid	calcaneonavicular
cerebron	phrenosin
cush-cush	couche-couche
children's table	kiddie table
cytometrical	cytometric
cog railway	rack railway
cyclism	cycling
cycle clip	bicycle clip
chondriosome	mitochondrion
crossing loop	passing loop
coast guarder	coastguardsman
chloralium	chloral
cytolymph	hyaloplasm
cerographical	cerographic
cardioangiography	angiocardiography
coprosterin	coprosterol
come back to one's senses	come to one's senses
chemokinetics	chemokinesis
cytocuprein	erythrocuprein
crystallogen	crystalloid
cytotechnician	cytotechnologist
chrome-plated	chromium-plated
countertraction	counterextension
colliotomy	adhesiotomy
cavy	guinea pig
chalice drum	goblet drum
computator	computer
cherish a snake in one's bosom	nourish a viper in one's bosom
candy glass	sugar glass
carpoptosis	wrist drop
correlationship	correlation
chloroleukaemia	chloroma
carubicin	carminomycin
climatization	acclimatization
capitellum	capitulum
crurotalar	talocrural
cheero	cheers
cytodendritic	dendritic
casodex	bicalutamide
counter-imperialist	anti-imperialist
chuck one's toys out of the pram	throw one's toys out of the pram
development limbo	development hell
disagglomerate	deagglomerate
deskbar	deskband
dorsomedian	dorsomedial
despirited	dispirited
damn your eyes	damn you
doudou	dudou
dwarvish	dwarfish
DNA profiling	genetic fingerprinting
does a bear crap in the woods	does a bear shit in the woods
dowsing rod	divining rod
decerebrize	decerebrate
deattach	detach
depraved-indifference murder	depraved-heart murder
drainpipe trousers	skinny jeans
deaccelerate	decelerate}}
digitron	Nixie tube
duck itch	swimmer's itch
deuteroplasm	deutoplasm
dermapigmentation	micropigmentation
dilatatory	dilatory
digametic	heterogametic
ductus deferens	vas deferens
deal with the devil	Faustian bargain
D-shackle	D-ring
dip one's toe in the water	test the waters
deproteinate	deproteinize
de la Chapelle syndrome	XX male syndrome
diminished capacity	diminished responsibility
desktop organizer	desk organizer
duck on drake	duck on a rock
densitometrics	densitometry
deoxyfluoroglucose	fluorodeoxyglucose
dry as a nun's cunt	dry as a nun's nasty
Darwinian medicine	evolutionary medicine
divoltine	bivoltine
dance mat	dance pad
drogue parachute	drogue
diachronical	diachronic
demiurgical	demiurgic
differentialize	differentiate
devil to pay	hell to pay
diagonal mark	slash
daotai	circuit intendant
dexedrine	dextroamphetamine
dodecaphonics	dodecaphony
dethiobiotin	desthiobiotin
desponsage	betrothal
dermolysis	dermatolysis
disbosom	unbosom
dead and gone	dead and buried
devitellinated	devitellinized
deep breathing	diaphragmatic breathing
disbalanced	unbalanced
dire wolf	warg}}
desert sore	veldt sore
Dandie	Dandie Dinmont
demon duck of doom	Bullockornis
double yellows	double yellow lines
dermotropic	dermatotropic
diethylenetriaminepentaacetic acid	pentetic acid
denounceable	denunciable
drop dimes	drop a dime
Danube salmon	huchen
dimethylpropane	neopentane
DNS server	domain name server
discombooberate	discombobulate
deep-breathing	diaphragmatic breathing
diphenyl	biphenyl
driving permit	learner's permit
denticular	denticulate
damnit	dammit
didelphous	didelphic
diacetic acid	acetoacetic acid
dioic acid	dicarboxylic acid
despirit	dispirit
do the job	do the trick
disactivate	deactivate
daughter isotope	daughter nuclide
dwarfen	dwarven
desk tidy	desk organizer
dorsed	aversant
denitrificator	denitrator
diagonal	slash
dark thirty	oh dark thirty
dyshematopoiesis	dyshemopoiesis
deoxyribotide	deoxyribonucleotide
dibenzopyrazine	phenazine
dextrimaltose	maltodextrin
degreasant	degreaser
Delmonico	Delmonico steak
dualski	biski}}
Dötz reaction	Wulff-Dötz reaction
Danishmendid	Danishmend
duraluminum	duralumin
death house	death row
Demopublican	Republicrat
densitograph	densitogram
dicyandiamide	cyanoguanidine
diradicaloid	biradicaloid
Donald Trumpish	Trumpish
disingenuity	disingenuousness
diphenylethyne	diphenylacetylene
donut peach	flat peach
dysbacteriosis	dysbiosis
dividend reinvestment program	dividend reinvestment plan
dechloruration	dechloridation
detax	untax
do gooseberry	play gooseberry
dysungulation	onychomadesis
deviometer	strabismometer
demyelinisation	demyelination
dirt pie	mud pie
dancing master's kit	kit violin
diskazine	diskzine
disirregardlessly	regardlessly
deoxytaurocholate	taurodeoxycholate
Dyson shell	Dyson sphere
do Abram	sham Abraham
dduk	tteok
delegated legislation	secondary legislation}}
deep draft	draft
dramamentary	docudrama
devil's picture books	devil's books
dog guide	guide dog
dance music	electronic dance music
diacetyl	butanedione}}
digitalization	digitization
dumpster bandit	trash panda
dope addict	drug addict}}
demi-hunter	half-hunter
didynamian	didynamous
day of judgment	judgment day
dumb network	dumb pipe
dimensional stone	dimension stone
duty ace	Old Frizzle
dihydrodiethylstilbestrol	hexestrol
debreziner	debrecener}}
duralum	duralumin
diazooxide	diazocyclohexadienone
de-Islamification	de-Islamization
deltoideopectoral	clavipectoral
dehydrosugar	anhydrosugar
daktarin	miconazole
Deerfieldian	Deerfielder
Davey Crockett cap	Davy Crockett hat
dimethylamidophenyldimethylpyrazolon	pyramidon
dolphin kick	butterfly kick
doplich	doplic
digestional	digestive
dermatosclerosis	scleroderma
dope glass	carnival glass
dehydroepiandrostenedione	dehydroepiandrosterone
diapophytoene	dehydrosqualene
dicophane	dichlorodiphenyltrichloroethane
diacrisis	diagnosis
discontinually	discontinuously
drainpipes	drainpipe trousers
dark magic	black magic
diamond poem	diamante poem
decodify	uncodify
demonographer	demonologist
Danic	Danish
dark market	darknet market
deer-pig	babirusa
dressing sack	dressing jacket
diadermic	diadermal
diphosphoglycerate	biphosphoglycerate
dynamagnite	nitromagnite
digitin	digitonin
demyelinization	demyelination
domination	cover
Dutch gin	jenever
desire path	desire line
diluvion	diluvium
duraluminium	duralumin
dystopianism	dystopia
disalignment	misalignment
day late, dollar short	a day late and a dollar short
daikon radish	daikon
deprenyl	selegiline
day of judgement	judgement day
dermatopathic lymphadenopathy	dermatopathic lymphadenitis
Dippel's oil	bone oil
data-structured coupling	stamp coupling
dichromatopsia	dichromatism
dysmaturation	dysmaturity
daily paper	daily
debreciner	debrecener}}
darkside	farside}}
dodecabenzocoronene	circumcoronene}}
dulcitol	galactitol
dermatotoxin	dermatoxin
derived class	subclass
dobbin	horse
dacryocele	dacryocystocele
DNA typing	genetic fingerprinting
dicrotous	dicrotic
ditag	paired-end tag
detritophage	detritivore
desk caddy	desk organizer
diphacinone	diphenadione
dentinum	dentin
demicharacter	demi-caractère
docimastics	docimasy
Dice coefficient	Sørensen-Dice coefficient
diagnostical	diagnostic
diamond bracket	angle bracket
densitometrical	densitometric
deprotoned	deprotonated
dorsodynia	dorsalgia
digynian	digynous
diacetylcholine	succinylcholine
dragnet mortgage	anaconda mortgage
DNA testing	genetic testing
double-pole technique	double poling}}
doudu	dudou
duckmole	platypus
dummy light	idiot light}}
data hiding	information hiding
death pool	dead pool
dermatotoxic	dermatoxic
Devil's Triangle	devil's threesome
disirregardless	regardless
dihydroflavonol	hydroxyflavanone
dollar dance	money dance
diodoquin	diiodohydroxyquinoline
debrecziner	debrecener}}
démêlé	quarrel
desulfatase	sulfatase
dance of death	danse macabre
Dutch tear	Rupert's drop
desktop organiser	desk organizer
distance education	distance learning
dualistical	dualistic
dangedest	darnedest
dystopical	dystopian
dermatopathia	dermatopathy
Dianetical	Dianetic
dicistronic	bicistronic
decision room	situation room
denigrative	denigratory
diagnosis	diagnose
deculturate	deculturize
deep-dish pizza	Chicago-style pizza}}
diamond planet	carbon planet
diplobacillus	diplobacterium
dyer's weed	dyer's rocket
declog	unclog
dramatist	playwright
dope man	drug dealer}}
DNA fingerprinting	genetic fingerprinting
driver's permit	learner's permit
dictatorialism	dictatorship
dihydrobenzene	cyclohexadiene
dandelion tea	dandelion coffee
dulcimore	Appalachian dulcimer
de-thatching rake	thatch rake
diocesal	diocesan
diphenylaminechlorarsine	adamsite
duded up	dudded up
decentral planning	decentralized planning
deoxythymidylate	thymidylate
Dalinian	Dalian
dolorogenic	dolorific
declarative	declaration
down-ticket	down-ballot
diacylglyercide	diglyceride
D.Phil.	Ph.D.
dendrologic	dendrological
drogue chute	drogue
double bourgeois	great primer
dude rancher	guest rancher
dot release	point release
dynamogenesis	dynamogeny
decylaldehyde	decanal
delime	unlime
directional pad	d-pad
dismembranator	dismembrator
dihydroxybutane	butanediol
diatexite	migmatite
digoxigenized	digoxigenated
Darzens condensation	Darzens reaction
domestic sciences	household arts
desuggestopedia	suggestopedia
deoxynucleic	deoxyribonucleic
dog-violet	dog's tooth violet
dementia café	memory café
deathlock	death grip
dindu	dindu nuffin
dramamine	dimenhydrinate
direct-to-TV	made-for-TV
deonym	theonym
duodecylaldehyde	dodecanal
dead fly biscuit	fly biscuit
disalign	misalign
duralium	duralumin
disilicate	sorosilicate
distomiasis	trematodiasis
dysmorphosis	dysmorphia
door drawer	pull-up boy
dadhood	fatherhood
decapodid	decapod
dyscephaly	dyscephalia
dog food	dog meat
dinoceras	uintathere
dwarf emu	Kangaroo Island emu
dirty washing	dirty laundry
dunderfuck	dumb fuck
dextrorsal	dextrorse
data stick	flash drive
Dantophilist	Dantophile
drum belly	hoove
discretamine	scoulerine
dephosphatase	phosphatase
draconical	draconic
dediazoniation	dediazotation
draft stop	firestop
dip net	hand net
Darier-Roussy syndrome	Darier-Roussy disease
dornase	deoxyribonuclease
dude ranch	guest ranch
exencephalia	exencephaly
erythroid	normoblast
enhancin	amoxocillin
ear coning	ear candling
electrospinned	electrospun
electrogradient	electrochemical gradient
erythrocytopoiesis	erythropoiesis
extramedullar	extramedullary
exurbian	exurban
epigynum	epigyne
erythrophilic	erythrophilous
endoglobular	endoglobar
ewwie	ew
elbow juice	elbow grease
electroengineer	electrical engineer
ectopeptidase	endopeptidase
Elizabethan sonnet	Shakespearean sonnet
electroshock therapy	electroconvulsive therapy
edathamil	ethylenediaminetetraacetic acid
electropermeabilize	electroporate
eschatologic	eschatological
epiloia	tuberous sclerosis
excitoneurotoxicity	excitotoxicity
epipodials	epipodialia
extremify	extremize
electron paramagnetic resonance	electron spin resonance
evejar	nightjar
epithelin	granulin
Einsteinism	Einsteinianism
endsheet	endpaper
erotematic method	Socratic method
eaglewood	agarwood
etiopathogeny	etiopathogenesis
ephebos	ephebe
endomesodermic	endomesodermal
equitensin	pentobarbital
echelon parking	angle parking
ectoflexid	ectostylid
extraerythrocytic	exoerythrocytic
erythrine	erythrite
endobulin	immunoglobin
embolophrasia	embololalia
epicanthic fold	epicanthus
endosternum	entoplastron
ergosterin	ergosterol
euthyreotic	euthyroid
encephalomeningocele	meningoencephalocele
eye-apple	apple of one's eye}}
expostulative	expostulatory
epiallopregnanolone	isopregnanolone
epicone	epitheca
erratas	errata
ergocristinine	ergocristine
event-based	event-driven
endovasculitis	endangiitis
Euroroute	E-road
endoclisis	mesoclisis
electroengineering	electrical engineering
easy	easy-oar
endocytoplasmic	intracytoplasmic
extratensive	extroverted
etiognosis	etiology
e-payment	cyberpayment
English breakfast	full English breakfast
eastly	easterly
evanescency	evanescence
ethyl ether	diethyl ether
engine compartment	engine bay
endometric	endometrial
epitomate	epitomize
Einsteinian relativity	relativity}}
elutant	eluent
equivolumic	equivolumetric
endocellularly	intracellularly
embryoscope	fetoscope
eat twat	eat pussy}}
epipodium	lamina
eights and aces	dead man's hand
exduction	lateroduction
eudaemony	eudemonia
erosible	erodible
entrepreneurism	entrepreneurialism
Embering	Ember day
e-hug	cyberhug
enjoyee	enjoyer
e-privacy	cyberprivacy
erubescite	bornite
enzymically	enzymatically
electroneurography	electroneuronography
entosarc	endosarc
exocompound	exo-isomer
endearing	endearment
exairesis	crossectomy
Eliotic	Eliotian
ectokinase	exokinase
epilemma	endoneurium
exogeology	astrogeology
erythrocin	erythromycin
eat cunt	eat pussy
empty page	blank canvas
exotunica	exoascus
ectothermal	ectothermic
euchromosome	autosome
electronometer	electrometer
epistemics	epistemology
eat boiled crow	eat crow
endoplastic	endoplasmic
extrahuman	nonhuman
eolienne	aeolian
effectful	effectual
economic rationalism	neoliberalism}}
extramatrix	extracellular matrix
electrodessication	electrocoagulation
estrum	oestrus
Eddington limit	Eddington luminosity
extrasolar planet	exoplanet
ecclesiologic	ecclesiological
extranumerary	supernumerary
eucupine	euprocin
electroformation	electroforming
eigennode	eigengene
emanatism	emanationism
evaporization	vaporization
Evans procedure	Evans technique
ethylnorantifeine	etimizol
Europid	Caucasoid
eloxatin	oxaliplatin
epilatory	depilatory
encephalosis	encephalopathy
eight-oar	eight
etherical	etheric
European radish	radish
epipodophylloid	epipodophyllotoxin
emiocytosis	exocytosis
extinction event	mass extinction}}
enhanced interview	torture
elderfather	eldfather
epistolatory	epistolary
exhibitionist	exhibitioner
encranial	endocranial
eka-astatine	tennessine
electrofolk	folktronica
epanutin	phenytoin
eurythermic	eurythermal
eyeline	eyestripe
exogalactic	extragalactic
eupelagic	pelagic
e-fame	cyberfame
entomologic	entomological
enneaploid	nonaploid
everyware	ubiquitous computing
ethylketocyclazocine	ethylketazocine
engoulée	engouled
exocanthus	exocanthion
euphorine	phenylurethan
electroplaque	electrocyte
ergosome	polysome
Essaism	Essenism
every once in a while	once in a while
episome	epitheca
electrowave	synthwave
eff and jeff	eff and blind
esocoid	esocid
empirical rule	68-95-99.7 rule
enmoisten	moisten
excementosis	hypercementosis
evangeliary	evangelistary
Eurodollar	euro
either-way offence	hybrid offence
equivalved	equivalve
e-fraud	cyberfraud
extroversive	extroverted
ektexine	sexine
emigratory	migratory
emanatist	emanationist
exclusionistic	exclusionist
epibrassicasterol	crinosterol
expirative	expiratory
everything including the kitchen sink	everything but the kitchen sink
Executive Ball Clicker	Newton's cradle
endoproct	entoproct
encephalitogenous	encephalitogenic
elephant grass	Napier grass
endgut	hindgut
epigenic	epigenetic
endophagocytosis	phagocytosis
electromyostimulation	myostimulation
epidermolysin	exfoliatin
easy as cake	easy as pie
enteroreceptor	interoceptor
enantiomerical	enantiomeric
eureka	constantan
English sonnet	Shakespearean sonnet
eye bleach	brain bleach
encephalocystocele	hydrencephalocele
edgrowth	edgrow
episodic wave	rogue wave
ethoglucid	etoglucid
edit distance	string distance}}
egotropic	egocentric
exploding cucumber	squirting cucumber
endograph	hypograph
extract the Michael	take the mickey
ekonting	akonting
envirospeak	ecospeak
eat beaver	eat pussy}}
electrofusing	electrofusion
esuriency	esurience
excursion rate	excursion fare
epiblem	rhizodermis
e-invite	e-invitation
egg sac	egg case
e-beggar	cyberbeggar
emeiocytosis	exocytosis
enterolite	enterolith
elliptocytosis	hereditary elliptocytosis
endoreplicated	endoreduplicated
embryonid	embryonic
enamoration	infatuation
entrochus	entrochite
ecodomain	ecoregion
ex-lax fish	escolar}}
electrocardium	electrocardiogram
euphory	euphoria
endocanthus	endocanthion
epixylic	epixylous
epiglottiditis	epiglottitis
exomion	exomis
eurythermous	eurythermal
exostosectomy	exostectomy
ereptase	erepsin
ethnobotanic	ethnobotanical
eigenscore	eigenfactor
encephalophone	electroencephalophone
extracardial	extracardiac
esylate	ethanesulfonate
epithelian	epithelial
enoughly	enough
ethohexadiol	etohexadiol
eurycomalactone	eurycolactone
event-based programming	event-driven programming
e-currency	cybercurrency
endoreplicate	endoreduplicate
encephalomeningitis	meningoencephalitis
eggnest	ootheca
eggs rancheros	huevos rancheros
eudemine	diazoxide
ectexine	sexine
endoprosthetic	endoprosthesis
expiry	expiration date
eulachon	candlefish
ethanenitrile	acetonitrile
ergostetrine	ergonovine
franciscana	La Plata dolphin
feminist dance therapy	underwater basket weaving
fan-assisted oven	convection oven}}
fill and flee	gas and dash
flick-screen	flip-screen
fire chicken	buldak
fasciculate	fasciculation
faineancy	faineance
French door	French window
fragmentocyte	schistocyte
forward-declare	predeclare
Foucault pendulum	Foucault's pendulum
fusospirillosis	acute necrotizing ulcerative gingivitis
fluorothane	halothane
for the love of shit	for the love of fuck
framework silicate	tectosilicate
fastloader	turboload
faveolated	faveolate
filovirid	filovirus
frottoir	rubboard
fanboat	airboat}}
French harp	harmonica
fastwalker	UFO
feels	emotional}}
frumentarian	frumentarious
four-string guitar	tenor guitar
flea's eyebrows	cat's whiskers
family guy	family man
full-point	full stop
Fennist	Finnicist
first-class value	first-class object
floriate	floriated
fascistly	fascistically
fibromyocyte	myofibroblast
flagecidin	anisomycin
Florence syndrome	Stendhal syndrome
frontate	frontated
fervorent	fervent
Florence fennel	finocchio
frying steak	chipsteak
fair dinks	fair dinkum
fretted dulcimer	Appalachian dulcimer
fraxiparine	nadroparin
fanfarade	fanfare
furol	furfural
fan oven	convection oven}}
fancy maid	fancy girl
flashtube	flashlamp
fruitivore	frugivore
Flemingian	Flandrian
float with the stream	go with the flow
fermentarian	prozymite
fonticulus	fontanelle
fox's foot	cocksfoot}}
flip turn	tumble turn
flying fig	flying fuck
feminology	women's studies
fudd	fuddy-duddy
Fascist	Nazi
fungicidin	natamycin
fanwankery	fanwank
facepalmy	embarrassing
fusing	fusion
forklift truck	forklift
feetwear	footwear
fortune-seeker	fortune hunter
food canal	alimentary canal
Farber's lipogranulomatosis	Farber disease
Fresnel rhomb	Fresnel's rhomb
factory pattern	factory method pattern
for Goddess's sake	for God’s sake
fusospirochetal gingivitis	acute necrotizing ulcerative gingivitis
Faulknerish	Faulkneresque
Fatimite	Fatimid
façade pattern	facade pattern
Ferrata cell	haemohistioblast
feminasty	feminist
fire cart	hwacha
ferromagnesic	mafic
first-class citizen	first-class object
follicularly challenged	follicly challenged
flagball	flag football
friaje	surazo
frontogenetical	frontogenetic
freedom kiss	French kiss
foreslash	slash
fuck your mother	fuck
folimycin	concanamycin
friendo	friend
fishtail skirt	mermaid skirt
forestry machine	forest machine
freedom dressing	French dressing
flange oiler	flange lubricator
forgetful	forgettable
fluid-bound	fluid-bonded
fascistical	fascistic
Fultonism	Atlanticism
firesand	chamotte
fire rainbow	circumhorizontal arc
feraxanase	feraxan endoxylanase
fucidin	fusidic acid
flip teaching	flipped learning
front company	shell company
floppy diskette	floppy disk
fartbox	arse
filtrator	filter feeder
fiesta dress	squaw dress
fairy circle	fairy ring
feel like oneself	feel oneself
final frontier	outer space}}
fluoroglucose	fluorodeoxyglucose
flu shot	flu jab
foul marten	polecat
firefighter's carry	fireman's carry
forage radish	fodder radish
four-string banjo	tenor banjo
forward stroke	forward slash
fall guy	scapegoat
forward reference	forward declaration
fog machine	fogger
full English	full English breakfast
finger fan	finger mask
forward slash	slash
facilities	facility
fullerol	fullerenol
fighter jet	jet fighter
file footage	file film
French canon	canon
free-speaking	free-spoken
fenocycline	doisynoestrol
follitropin	follicle stimulating hormone
fair shake of the sauce bottle	fair suck of the sauce bottle
ferret about	ferret around
fruit rollup	fruit leather}}
frequentile	quantile
freedom toast	French toast
fox caller	fox whistle
Fahr disease	Fahr's syndrome
fortune seeker	fortune hunter
fantasmascope	phenakistoscope
fish hurricane	fish storm}}
frobnitz	gizmo
for the love of Goddess	for the love of God
fistical	fistic
frog-walk	frogmarch
fresh pursuit	hot pursuit}}
Forer effect	Barnum effect
floatline	corkline
form of address	term of address
frilled-neck lizard	frilled lizard
fur out	fur
foveal zone	foveal avascular zone
fuck your mother's cunt	fuck
five-dollar word	ten-dollar word
fish louse	carp louse
floating cellular data	floating car data
frammis	gizmo
frattish	fratty
front butt	front bottom
fowl pest	Newcastle disease
Freemasonism	Freemasonry
Fayum portrait	mummy portrait
flight ticket	air ticket
front slash	slash
frog's march	frogmarch
freedom bread	French bread
fruitcase	exocarp
faggot marriage	gay marriage
formée	patté
French bread	baguette}}
fudepen	brush pen
finger piano	thumb piano
foquism	focalism
freedom tickler	French tickler
flange greaser	flange lubricator
fee simple subject to executory limitation	fee simple subject to executory interest
fill and fly	gas and dash
frost quake	cryoseism
fagmo	gay
falseheart	false-hearted
first-class entity	first-class object
freak folk	psychedelic folk
fair suck of the sav	fair suck of the sauce bottle
final straw	last straw
guldenthaler	guldengroschen
goddessdamn	goddamn
giantism	gigantism
gebiid	gebiidean
girl juice	pussy juice
glutinoid	gelatinoid
GB	GiB
geriatry	geriatrics
graving dock	drydock
galizona	mandora
gastral	gastric
genderbend	genderswap
Gabor function	Gabor atom
ghetto palm	tree of heaven
golgiosome	dictyosome
Goddess bless	God bless
Gabor	Gabor patch
Grundy number	nimber
get-up	get-up-and-go
give a crap	give a shit
goji berry	wolfberry
go bag	bug-out bag
GMO-free	GM-free
golden number	golden ratio
get up on the wrong side of bed	get up on the wrong side of the bed
granduncle	great-uncle
good Goddess	good God
gratinée	gratin
groupo	groupset
grade-A	A-grade
ganoblast	ameloblast
go juice	go-go juice
gastroanastomosis	gastrogastrostomy
guiro	sekere
guldiner	guldengroschen
gnostic atheist	hard atheist
gastrosoph	gastrosopher
galactofuran	galactofuranose
get it through one's skull	get it through one's head
gastrogenous	gastrogenic
glutathiolation	glutathionylation
geoposition	geolocation
giant daikon	Sakurajima radish
Goddess bless you	God bless you
gastroenterologue	gastroenterologist
game fish	sport fish
gallichone	mandora
gentilicium	nomen gentilicium
gender confirmation surgery	sex reassignment surgery}}
granny glasses	granny specs
Greenland spar	cryolite}}
gokhru	gokshura
Golden Horus name	gold name
geometrical progression	geometric progression
gazoo	kazoo
genitocrural	genitofemoral
galactowaldenase	phosphogalactoisomerase
giant squid	Cthulhu}}
glinide	meglitinide
guldentaler	guldengroschen
gender panembung	slenthem
gigmanism	gigmanity
gangshag	gangbang
geobiotic	terrestrial
Groundhog Lodge	Grundsow Lodge}}
Gb	Gib
gaming console	video game console}}
go down the pan	go down the toilet
Greek number	Greek numeral
ghost field	Faddeev-Popov ghost
go down the tubes	go down the toilet
gardimycin	actagardine
global coupling	common coupling
greyzem	boroll
grand final	big final}}
great-nephew	grandnephew
get it together	get one's act together
grasp for straws	grasp at straws
gay as a lark	happy as a lark
Gregory's mixture	Gregory's powder
glossogenetics	glossogenesis
geomorphodynamics	morphodynamics
gulpable	quaffable
garbage bandit	trash panda
gudge	gur cake
guinea	guinea fowl
gorton	creton}}
gastroesophageal reflux	heartburn}}
go pedal	accelerator}}
granulocytopoiesis	granulopoiesis
grammar cop	grammar police
grandaunt	great-aunt
ghost moose	spirit moose}}
gastroderm	endoderm
Grecianism	Grecism
general paralysis	general paresis of the insane
gentilitian	gentilitial
goddessdammit	goddammit
give lie to	give the lie to}}
green indigo	lokao
glass bone disease	osteogenesis imperfecta
grain weevil	wheat weevil
great-niece	grandniece
golden falcon name	gold name
galenite	galena
grins-and-giggles	kicks-and-giggles
glycerine trinitrate	nitroglycerine}}
general paralysis of the insane	general paresis of the insane
ghost chili pepper	bhut jolokia}}
goofus	doofus
glass tear	Rupert's drop
gin jockey	gin burglar
gynomania	transvestism
grass staggers	stomach staggers
gauge ghost	Faddeev-Popov ghost
go down the tube	go down the tubes
garamycin	gentamicin
glossolalia	xenoglossy
gainworthy	affordable
ghost chilli	ghost pepper
gents'	men's room
Gradgrindish	Gradgrindian
gentlemen's	men's room
gerontologic	gerontological
gravity slingshot	gravity assist
give a bugger	give a shit
ghost runner	invisible runner
give two shits	give a shit
garden shears	pruning shears
gentiopicroside	gentiopicrin
gliocytoma	glioma
glucomutase	phosphoglucomutase
genitals	genitalia
good bet	safe bet}}
go soak your head	get bent
glycosylaminogylcan	glycosaminoglycan
gentilitious	gentilitial
glucolysis	glycolysis
gynocracy	gynecocracy
granary weevil	wheat weevil
get the meaning	take the meaning
gyrorotary	gyrational
get a pair	grow a pair
golden alga	chrysophyte
glucurolactone	glucuronolactone
giant octopus	Cthulhu}}
give one's right arm	give one's eye-teeth
Grande Dame Guignol	hagsploitation
gray-blue	blue-gray
gimme cap	trucker hat
glucamide	chlorpropamide
gimme hat	trucker hat
gladden someone's heart	warm someone's heart}}
grey-blue	blue-gray
ghost pepper	bhut jolokia}}
galvanometrical	galvanometric
grande finale	big final}}
glycerophosphatide	phosphoglyceride
Grecian laurel	true laurel
gutbucket	washtub bass
gelification	gelatinization
gramagrass	grama
Gilles de la Tourette syndrome	Tourette syndrome
Gowkie Day	April Fools' Day
garbanzo bean	chickpea}}
gastrogavage	gavage
gamogony	gametogony
gravity bong	waterfall bong
glider	glide
grossularite	grossular
GMing	Dungeon Mastering
gimbri	sintir
guitar cello	arpeggione
Graecicize	Grecize
German wheat	spelt
gigacycle	gigahertz
gawkers' block	gapers' block
gelatin salad	congealed salad}}
glyceryl trinitrate	nitroglycerine}}
grandparent	grandfather
giant white radish	Sakurajima radish
grammaticolexical	lexicogrammatical
geepound	slug
grub out	grub up
grammatischer Wechsel	Verner alternation
gnostical	gnostic
Glyconic	Glyconian
grease money	grease payment
gopar	gopnik
Goddess forbid	God forbid
gazooka	kazoo
grow a set	grow a pair
geniohyoglossus	genioglossus
granuloblast	myeloblast
go to the bad	go bad
go walkies	go walkabout
good people	good folk
gas and go	gas and dash
German lute	lute guitar
glycerol trinitrate	nitroglycerine}}
gravity brightening	gravity darkening
genderpunk	genderfuck
gleyosol	gleysol
gastric flu	stomach flu
gallichon	mandora
greater saphenous vein	great saphenous vein
gob off	shoot one's mouth off
gastrolienal	gastrosplenic
guiderail	guardrail}}
game mastering	Dungeon Mastering
granulomere	chromomere
go down the drain	go down the toilet
ghost chili	bhut jolokia}}
gentlemen's room	men's room
gliocyte	glial cell
glucosan	glucan
geotectonism	geotectonics
Germanic h	aspirated h}}
geiko	geisha
galareta	p'tcha
gumband	rubber band
gasometrical	gasometric
glucosylceramide	glucocerebroside
gaiwan	chawan
glitterball	mirrorball
geobiochemical	biogeochemical
ground control	air traffic control
glucide	glycose
go down the khazi	go down the toilet
Guthrie's sweet whiskey	chloroform}}
General Tao chicken	General Tso's chicken}}
greater yam	name
glass snake	glass lizard}}
gouttée	gutty
Greenland seal	harp seal}}
German pizza	flammkuchen}}
gop	gopnik
girdle scone	Welshcake
granger railroad	granger road
grewhound	greyhound
gaussmeter	magnetometer
gaycism	homophobia
guitar-player	guitarist
graviola	soursop
Han character	Chinese character
heterotransplant	heterograft
hydraulic organ	water organ
have a crow to pick	have a crow to pull
hallelu	hallelujah
heregulin	neuregulin
histioid	histoid
hydriskos	hydriske
Hanafite	Hanafi
homochromatic	monochromatic
hurdy-gurdy	street organ
hysteritis	metritis
hairpin curve	hairpin bend
haldi	turmeric
hyperlogia	logorrhea
HWIL	HIL
have one's wicked way with	have one's way with
hell-bent for leather	hell-bent
hair curler	hair roller
hylicism	hylism
hemianatropous	hemitropous
hemocateresis	eryptosis
homogeneic	homogenous
Hartmann's operation	Hartmann's procedure
hyperandrogenemia	hyperandrogenism
hemicholinium	hemicholine
housecar	motor home
human statue	living statue
hyperthyreosis	hyperthyroidism
Hanzi	Chinese character
harp-player	harpist
half duplex	semiduplex
hyperdiamond	24-cell
heart-splitting	heart-rending
horned snake	horned viper
horn of Amalthea	cornucopia
homodromic	homodromous
hydroxyaniline	aminophenol
heir general	heir-at-law
hallway health care	hallway medicine
hematopoietin	erythropoietin
hydrocoupling	hydrodimerization
Hand of Miriam	Hand of Fatima
hagiographist	hagiographer
home appliance	household appliance
homestanding	homestand
hyporesponsivity	hyporesponsiveness
humanpower	manpower
hysteria	conversion disorder}}
hepatoprotectant	hepatoprotective
hepaticoduodenostomy	hepatoduodenostomy
hepatomancy	hepatoscopy
hyposulfate	dithionate
hyon'gum	geomungo
historic	historical
hosted bar	open bar
horned horse	gnu
homosexophobia	homophobia
hornpout	horned pout
hatti	hatti-sherif
heterosexualism	heterosexuality
hyperbolic number	split-complex number
heptaoxodisilicate	pyrosilicate
heptaldehyde	heptanal
have a crow to pluck	have a crow to pull
header guard	include guard
happycore	happy hardcore
hot ice	sodium acetate trihydrate}}
halfa	esparto
homoclinal	homoclinic
heatplot	heat map
homeopathical	homeopathic
histoneurology	neurohistology
hallway hospitalization	hallway medicine
hit the sauce	hit the bottle
hedge warbler	dunnock}}
heterotransistor	heterojunction
harp of David	begena
hexanestrol	hexestrol
hormonology	endocrinology
hagiologic	hagiological
hecks no	heck no}}
Hispaniolize	Spaniolize
hawknut	kippernut
hereinbelow	hereinunder
hypospleny	hyposplenism
hyperspasmia	convulsion
hemitubular	semitubular
hook shop	brothel
hyperlucas	hyperfibonacci
horn violin	Stroh violin
hedonic calculus	felicific calculus
horn-violin	Stroh violin
homonegativism	homonegativity
happy day scenario	happy path
hydraulis	water organ
heterolateral	contralateral
honey ant	honey-pot ant}}
hypoalgia	hypoalgesia
haemoblast	haematoblast
heavy client	fat client
Horus of Gold name	gold name
hexaplicate	sextuplicate
heck no	hell no}}
hemostasia	hemostasis
hypocritic	hypocritical
hemiparasitically	semiparasitically
hyperoctant	orthant
how about	what about
hirulog	bivalirudin
hardun	stellion
hypoeutectoid	hypoeutectic
halohydrocarbon	halocarbon
hypermese	lichanos
Hamiltonian operator	Hamiltonian
hypermutagenesis	hypermutation
Halligan tool	Halligan bar
helmet shell	helmet snail
Harijan	Dalit
halogenide	halide
horn coral	rugosan
hornpipist	hornpiper
hypnotical	hypnotic
hot second	hot minute
homeotics	homeosis
hyperphagia	polyphagia
horseshoe worm	phoronid
hematotoxic	hemotoxic
haloalkylating	haloalkylation
hold a light	hold a candle
heave in view	heave in sight
housefrock	housedress
hotgun	hot glue gun
hangman paradox	unexpected hanging paradox
hypohaline	hyposaline
hepatologic	hepatological
hydroethidine	dihydroethidium
histoantigen	histocompatibility antigen
hyperglucocorticoidism	hyperadrenocorticism
haptoglobulin	haptoglobin
hydrocortisol	hydrocortisone
hallway healthcare	hallway medicine
heath woodrush	common woodrush
horn pipe	pibgorn
horror film	horror movie
hyperalgia	hyperalgesia
hominiform	hominid
hoverslam	suicide burn}}
hypoglucosis	hypoglycemia
hepatosteatitis	hepatosteatosis
hematotoxicity	hemotoxicity
hemocuprein	erythrocuprein
haüyne	hauynite
hyperoctahedron	16-cell
hyperchromism	hyperchromicity
hyperimperialism	ultraimperialism
hamburger sauce	burger sauce}}
hydrotropy	hydrotropism
hemoporphyrin	hematoporphyrin
headborough	tithingman
hydromorphic	hydric
hydraulus	water organ
hit two targets with one arrow	kill two birds with one stone
homolysin	isolysin
heterovariant	homosubtypic
hyperchlorate	perchlorate
hetaryl	heteroaryl
hyponitric acid	hydroxynitramide
hexapolyploid	hexaploid
harlequin ice cream	Neapolitan ice cream
hemoglobulin	hemoglobin
hyperemphasis	overemphasis
hematocytometer	hemocytometer
heteronymic	heteronymous
here goes	here we go
Horus name	serekh name
hare's foot	harefoot}}
hyperreact	overreact
heel-dragger	footdragger
horsehair shirt	hairshirt
halobetasol	ulobetasol
hydrogen carbonate	bicarbonate
homoplasiously	homoplastically
hunting leopard	cheetah
health tourism	medical tourism
histograph	histogram
haglin	hagdon
hypovirilization	undervirilization
hypercalciuric	hypercalcinuric
heteronucleic	heteronuclear
heat plot	heat map
hyetogram	hyetograph
hebephreniac	hebephrenic
hyperhaline	hypersaline
Huntington's chorea	Huntington's disease
hackerism	hackerdom
hoot owl	barred owl
hextuplicate	sextuplicate
hydroxyperoxidase	hydroperoxidase
high-frequency trading	program trading
hyphenize	hyphenate
heterocyclical	heterocyclic
heparinated	heparinized
homo marriage	same-sex marriage
hold baggage	hold luggage
heterobasionym	synonym
head orgasm	autonomous sensory meridian response
horned toad	horned frog
heterocarpism	heterocarpy
horticulturalism	horticulturism
hawklet	hawkling}}
hypodopaminergia	hypodopaminergism
hardingfele	Hardanger fiddle
household god	household deity
hide the salami	hide the sausage
hyperphonon	hypervibration
hyperreflexivity	hyperreflexia
hepatocuprein	erythrocuprein
hom mali rice	jasmine rice}}
headsheet	headcloth
housewifehood	housewifery
homogenation	homogenization
hyalectan	lectican
haakdoring	hookthorn
hip-hop honey	video vixen
Harvey Smith	Harvey Smith salute
heliotropyl	piperonyl
hemicylinder	semicylinder
Hohmann orbit	Hohmann transfer orbit
hippiatrics	hippiatry
hedonistic calculus	felicific calculus
hypocoristical	hypocoristic
hyaloiditis	hyalitis
horned hog	babiroussa
hoodooism	voodooism
hemicircular	semicircular
housemaking	homemaking
holy piss	holy shit
hackfest	hackathon
hemivoltine	semivoltine
hanky-pank	hanky-panky
hepaprotective	hepatoprotective
halieutical	halieutic
homothermal	homothermic
homofaggot	homosexual
high blood pressure	hypertension}}
hexabenzobenzene	coronene}}
hemorheologic	hemorheological
hemifluorinated	semifluorinated
Hindu-Arabic numeral	Arabic numeral
hepatorenoprotective	hepatonephroprotective
hepatogenous	hepatogenic
hanging tree	gallows tree
headbox	headrail
heebies	heebie-jeebies
harmonicaist	harmonicist
hydroferrocyanic acid	ferrocyanic acid
hydrolyzed vegetable protein	monosodium glutamate
Hanafist	Hanafi
hexic	sextic
historical	historic
handling fee	handling charge
hooping cough	whooping cough
hydroxyadamantane	adamantanol
Hashimoto-Pritzker disease	Hashimoto-Pritzker syndrome
homobasidium	holobasidium
Hissian	goose
hoofrot	footrot
hyletic	hylic
heterosulfide	heterodisulfide
hairpin turn	hairpin bend
hydroethidium	dihydroethidium
high profile	high-profile
hexarelin	examorelin
hydroxypropane	propanol
hepatin	glycogen
hump and dump	smash and dash
hackspace	hackerspace
horror flick	horror movie
helper verb	helping verb
haole time	White People's time
Heaviside layer	Kennelly-Heaviside layer
hardim	stellion
helper dog	service dog
hat head	hat hair
hamburger steak	Hamburg steak
intergendered	intergender
inerect	unerect
isovariant	isoform
interiorized stuttering	covert stuttering
inflatable castle	bouncing castle
isopentanoate	isovalerate
internunciatory	internuncial
interactionalist	interactionist
improtected	unprotected
interferometrical	interferometric
interschools	interschool
Indian fig	cluster fig
inferent	afferent
ionic wind	ion wind
informationization	informatisation
inthronization	enthronement
indexal	indexical
immunomodulative	immunomodulatory
Indiana Jonesian	Indiana Jonesesque
iminoxyl	alkylideneaminoxyl
immunorepressive	immunosupressive
intersexualize	intersex
izafet	ezafe
imperfect fungi	fungi imperfecti
itive	andative
iliotibial band friction syndrome	iliotibial band syndrome
isotopic spin	isospin
ishkhan	Sevan trout
interfractional	interfraction
infraspinatous	infraspinal
iced capp	frappuccino}}
interphalanx	interphalangeal
intextine	endexine
iconostas	iconostasis
imprepared	unprepared
Italian tomato	Roma tomato}}
intradermically	intradermally
immunopathologic	immunopathological
icicle radish	daikon
ill-got gains	ill-gotten gains
infracommunity	infrapopulation
isogenetic	isogenous
indolone	oxindole
interdermal	subdermal
immunoantigen	antigen
immunolocation	immunolocalization
interiorized stutter	covert stuttering
isosteroid	isosteroidal
inside dealing	insider trading
inobscurable	unobscurable
intradermic	intradermal
illiberty	unfreedom
immunotolerize	tolerize
Indian saffron	turmeric}}
institutionism	institutionalism
interventionalist	interventionist
Illyric	Illyrian
interion	interionic
iridescent ware	carnival glass
interpreting	interpretation
iliotibial tract	iliotibial band
Internet banking	e-banking
irrealizable	unrealizable
indigotic acid	nitrosalicylic acid
industrial store	company store
informationize	informatize
interserotype	interserotypic
isoelectricity	isoelectric focusing
Indian harp	esraj
insulationism	isolationism
immunoenzyme	immunoenzymatic
immunohistopathologic	immunohistopathological
isothiazolone	isothiazolinone
information technology bubble	dot-com bubble
isoascorbic acid	erythorbic acid
inclusion complex	inclusion compound
ice sled hockey	sledge hockey}}
invariously	invariably
Indonesian cassia	Indonesian cinnamon
immunodomination	immunodominance
isopropyloxy	isopropoxy
indiscernibleness	indiscernibility
Idiazabal	Idiazabal cheese
indubiously	without a doubt
irradiancy	irradiance
iodinase	thyroperoxidase
infrahepatic	subhepatic
isoheight	isohypse
intoxification	intoxication
informationalisation	informatization
IP telephony	VoIP
iron pyrites	pyrite
inanery	inanity
ichnographical	ichnographic
intransigency	intransigence
immunoreactant	immunoreactive
indigenous medicine	folk medicine
impatriotic	unpatriotic
Italian rice ball	arancino}}
interrogative-point	question mark
iron pyrite	pyrite
idiolalia	idioglossia
islesman	isleman
isochromene	benzopyran
idiotistic	idiotic
ice disk	ice circle}}
inferible	inferable
insular tameness	island tameness}}
inlet manifold	intake manifold
ice tsunami	ice shove}}
insider dealing	insider trading
inequivalved	inequivalve
immunocytostaining	immunohistostaining
iron(III) chloride	ferric chloride
Ivory Coastian	Ivorian
illogic	illogical
isogeranial	isocitral
Indian darter	Oriental darter
Ivory Coaster	Ivorian
isotropical	isotropic
irisin	iridin
in flying colors	with flying colors
incident ticket system	issue tracking system
intimidative	intimidating}}
Iridill	carnival glass
ischemial	ischemic
irresectability	unresectability
ice disc	ice circle}}
inhauler	inhaul
impopularity	unpopularity
inacceptably	unacceptably
isonitroso compound	oxime
interactionalism	interactionism
intermorainal	intermorainic
invigorant	invigorating
Internet bubble	dot-com bubble
indicamine	lagerstroemine
ion storm	ICME
isophosphamide	ifosfamide
interscapilium	interscapulum
incannulation	cannulation
interrogative	question mark
inferrible	inferable
intrarachidian	intraspinal
irretractable	nonretractable
improfitable	unprofitable
Ivan Ivanovich	John Doe}}
isofucosterol	avenasterol
Italian sonnet	Petrarchan sonnet
isoquinolinone	isoquinolinol
inclusion polymorphism	subtype polymorphism
isofocusing	isoelectric focusing
iwana	charr
Indian lemonade	sumacade
intensity	radiance
iminooxy	alkylideneaminoxyl
inductance coil	choking coil
Italian Spinone	Spinone Italiano
isoelectrophoresis	electrofocusing
Iraqibacter	Acinetobacter baumannii}}
island silicate	orthosilicate
ivory palm	tagua palm
imariware	imari
in a way of speaking	in a manner of speaking
interjurisdiction	interjurisdictional
isotopomerase	topoisomerase
idrialine	idrialite
Ilfochrome	Cibachrome
ithmid	soorma
innervate	innerve
inside trading	insider trading
imidamide	amidine
Italian wedding soup	wedding soup
Iberic	Iberian
immeasurability	immeasurableness
iminoxy	alkylideneaminoxyl
infraspinous	infraspinal
incongruitous	incongruous
isooxazoline	isoxazoline
infochemical	pheromone
immunoradioassay	radioimmunoassay
ion chromatography	ion exchange chromatography
insulinitis	type 1 diabetes
indris	indri
immunoepitope	epitope
Kallang Wave	Mexican wave
kitchen sign	home sign
kitty-cornered	kitty-corner
kavapyrone	kavalactone
kerfluff	kerfuffle
kilawin	kinilaw
kavakava	kava
kneipping	Kneippism
kitassato flask	Büchner flask
kidney dagger	bollock dagger
kila	phurba
Korean-style short ribs	flanken short ribs}}
kobza	bandura
ketamide	cetrimide
kytoplasma	nucleoplasm
knock someone's lights out	punch someone's lights out
Kármán street	von Kármán vortex street
Kleene operator	Kleene star
Kautskyist	Kautskyite
kharza	yellow-throated marten
Korean radish	daikon
keyboarder	keyboardist
kazooer	kazooist
keep ahead	stay ahead
keratinic	keratinous
know what one is doing	know what one is about
kryptoxanthin	cryptoxanthin
konpa	compas
keytop	keycap
kafindo	onyalai
karyotheca	nuclear membrane
kontra	bugarija
kolam	rangoli
knave of clubs	jack of clubs
Karman street	von Kármán vortex street
Killing vector field	Killing field
know one's ass from one's elbow	know one's ass from a hole in the ground
kombivan	kombi
kleptochloroplast	kleptoplast
know one's head from a hole in the ground	know one's ass from a hole in the ground
kaiten	sushi train
kissworthy	kissable
kinnor	begena
koroona	novuss
know-everything	know-it-all
ketohexokinase	fructokinase
kerectomy	keratectomy
Karman vortex street	von Kármán vortex street
kente cloth	kente
komungo	geomungo
knock	hunger knock
khatna	khitan
kusunol	valerianol
kotylos	cantharus
knuckle-scraper	knuckle dragger
Kartvel	Kartvelian
knockaround	knockabout
keyed fiddle	nyckelharpa
know what's o'clock	know what is what
Kwakiutl	Kwakwaka'wakw
King David's harp	begena
keep one's breath to cool one's porridge	save one's breath to cool one's porridge
kalamaki	souvlaki
know the difference between one's ass and one's elbow	know one's ass from a hole in the ground
Kármán vortex street	von Kármán vortex street
knurr and spell	trap ball
kumascope	cymoscope
know someone from a can of paint	know someone from Adam
know what o'clock it is	know what is what
kersplode	explode
karyopyknosis	pyknosis
kaen	khene
Kermode	Kermode bear
kilogram-force	kilopond
kunik	Eskimo kiss
kinetical	kinetic
kotyle	cantharus
krupnikas	krupnik
kiss the dust	bite the dust
kittywampus	cattywampus
khoum	khoums
ladycow	ladybird
LEM lifeboat	lunar lifeboat
ladyfolks	ladyfolk
lipidogenic	lipogenic
ladies and germs	ladies and gentlemen
lesbian lizard	New Mexico whiptail
landfill site	landfill
laughing group	autobus
laboratory coat	lab coat
lobulate	lobulated
liposaccharide	lipopolysaccharide
lowlifer	lowlife
lyoprotective	lyoprotectant
lick my balls	suck my balls
Lokele	Kele
lo bak	daikon
lavvy paper	toilet paper
lithoglyphic	lithoglyptic
Lorena Bobbitt	emasculation
landing field	airfield
legal holiday	public holiday
liquid bread	beer}}
lunulated	lunulate
Latino/a	Latina/o
linean	linear
lymphadectomy	lymphadenectomy
libido	albedo
language laboratory	language lab
little dog syndrome	small dog syndrome
lucumone	lucumo
lasagne	lasagna
logical punctuation	logical quotation
lockchester	woodlouse
lean client	thin client
lectical	lectic
love apple	tomato
Lezgian	Lezgi
libertarian communism	anarcho-communism
lake itch	swimmer's itch
look lively	look alive
looks and feel	look and feel
Lipowitz's alloy	Wood's metal
Laysan teal	Laysan duck
line of apsides	apse line
loosely-typed	weakly-typed
luteoloside	cynaroside
laurinaldehyde	dodecanal
limnologic	limnological
lovelihead	loveliness
long-play	LP
loimology	epidemiology
localitis	clientitis
Liberty measles	German measles
lupron	leuprolide
leave someone on seen	leave someone on read
liberal education	general education
linen hall	cloth hall
lamellipod	lamellipodium
lunamarine	punarnavine
leaf wasp	sawfly
lactorrhea	galactorrhea}}
lithographic stone	lithographic limestone
lantern berry	Chinese lantern
lipomelanic reticulosis	dermatopathic lymphadenitis
lazy initialisation pattern	lazy initialisation
lichenization	lichenification
laterly	later
legumine	casein
linotyper	linotypist
logaphasia	motor aphasia
libfuck	liberal
light green cell hormone	dorsal body hormone‎
low-beam	dipped headlight
loan translation	calque
lemonol	geraniol
lutar	lute guitar
lutamide	flutamide
little boys' room	men's room
learner's license	learner's permit
leucinic acid	leucic acid
law calf	law binding
lentiretrovirus	lentivirus
laryngopharyngitis	pharyngolaryngitis
laugh on the wrong side of one's mouth	laugh on the other side of one's face
loo paper	toilet paper
luminograph	luminogram
limejuice	lime juice
lomentum	loment
luncheon sausage	luncheon meat
little summer of St Luke	St. Luke's summer
Leyden phial	Leyden jar
lowerclassman	underclassman
leukokinin	tuftsin
lesbian dance theory	underwater basket weaving
lancier	lancer
low breathing	diaphragmatic breathing
little summer of St. Luke	St. Luke's summer
life and soul of the party	life of the party
lily of the Incas	Peruvian lily
limnobiological	limnobiologic
liripipium	liripoop
lexic	lexical
licareol	linalool
Louis sauce	Louis dressing
larcenious	larcenous
language-independent	language-agnostic
lickspit	lickspittle
leavening	leavening agent
lithographic slate	lithographic limestone
lucky duckling	lucky duck
lesser seal script	small seal script
leewards	leeward
lateral sulcus	sylvian fissure
lithotripsical	lithotripsic
leukomonocyte	monocyte
LM lifeboat	lunar lifeboat
layer cake federalism	dual federalism
legal age	age of majority
lead fiddle	first fiddle
lactoserum	whey
little science	small science
Livvi	Olonets
lactotrope	lactotroph
latestly	latest
light skirts	lightskirt
ladsy	laddish
libshit	liberal
leave be	let be
Levantine	Franco-Levantine
lift surfing	elevator surfing
lymphaticovenous	lymphaticovenular
leprechaunism	Donohue syndrome
loxodromical	loxodromic
latte liberal	limousine liberal
lysotype	phagotype
languette	lingula
leave one's options open	keep one's options open
Landolt ring	Landolt C
Lolitaish	Lolitaesque
longipalatal	dolichuranic
lowest common multiple	least common multiple
limitans	membrana limitans
Lofstrom loop	launch loop
lysosphingolipid	sphingosine phosphate
lightland	Akhet
long white radish	white radish
long spine board	spine board
long-period	non-periodic
lissotrichian	lissotrichous
lymphoplasmacytoid	lymphoplasmacytic
longboard	spine board
lactotropic	lactotrophic
litany stool	litany desk
Lou Gehrig's disease	amyotrophic lateral sclerosis
leiomyoblastoma	leiomyoma
leucomycin	kitasamycin
lactacidemia	lacticemia
like a bitch	a lot
lignase	ligninase
Lugol's solution	Lugol's iodine
lobster trap	lobster pot
legal heir	heir-at-law}}
light-skirts	lightskirt
lap dulcimer	Appalachian dulcimer
Landolt broken ring	Landolt C
landborne	grounded
laughfest	laughathon
little girls' room	ladies' room
lesser saphenous vein	small saphenous vein
learning permit	learner's permit
love rectangle	love quadrangle
lava bomb	volcanic bomb}}
musical sawist	sawist
Montreal seasoning	Montreal steak spice}}
myocardial infarct	myocardial infarction
myelonic	myelonal
Miwokan	Miwok
metagraphy	transliteration
Morrison shelter	Morrison table
midboss	miniboss
Masorite	Masorete}}
Mormon funeral potatoes	funeral potatoes
manyplies	omasum
methylbutyrylcarnitine	isovalerylcarnitine
Marianism	Marianismo
misdirective	misleading
monoboard	monoski
mesokurtotic	mesokurtic
myeloaccumulation	myeloproliferation
museographist	museographer
menz	men
moroctic acid	stearidonic acid
methylestrenolone	normethandrone
midwoofer	midwoof
manousheh	manakish
Malay kite	Eddy kite
mycetology	mycology
maxofacial	maxillofacial
milk scall	cradle cap
methylpentose	deoxyhexose
multihyphened	multihyphenated
motor show	auto show
movie crew	film crew
molar tooth	molar
mesoploid	mesopolyploid
machboos	kabsa
Meares-Irlen syndrome	Irlen syndrome
metastasization	metastasis
microaphanitic	cryptocrystalline
mimiambus	mimiamb
missing white girl syndrome	missing white woman syndrome
mountain dulcimer	Appalachian dulcimer
mesion	meson
monopotential	monopotent
Midan	Midasian
miracle fruit	miracle berry
maltodextrose	glucose
musica universalis	music of the spheres
monovariate	univariate
malcontented	malcontent
matricial	matric
mouth harp	harmonica
mini excavator	mini digger
midget tossing	dwarf tossing
mince matters	mince words
marabou stork	marabou
metholox	methalox}}
malfolded	misfolded
Montenegran	Montenegrin
monodigital	monodigit
mlungu	mzungu
milk crust	cradle cap
metafane	methoxyflurane
millrun	mill race
moral arithmetic	felicific calculus
macaronian	macaronic
mycetocyte	bacteriocyte
malonyldialdehyde	malondialdehyde
Mechanical Turker	Turker
mushroom brush	kabuki brush
multiperforation	multipunch
meat rod	penis
Michael addition	Michael reaction
marcaine	bupivacaine
man-size	man-sized
macrophagocyte	macrophage
mzungu time	White People's time
multisited	multisite
milk gravy	sawmill gravy
mycetobiont	mycobiont
mythus	mythos
milk leg	phlegmasia alba dolens
melodyhorn	melodica
maieutics	Socratic method
monovoltine	univoltine
monocytemia	monocytosis
mesocranial	mesocephalic
mesophilous	mesophilic
microdick	micropenis
monozygous	monozygotic
mumhood	motherhood
MIR	mail-in rebate
marcando	marcato
microautoradiograph	microautoradiogram
multipurposed	multipurpose
multigestational	multigestation
mindswapping	bodyswapping
medical center	clinic}}
Mach diamond	shock diamond
metomidine	medetomidine
motoreductor	gearmotor
myoinhibiting	myoinhibitory
moroctic	stearidonic
methanimine	azomethine
metropathy	metropathia
malmstone	malm}}
museum problem	art gallery problem
money crop	cash crop
marble egg	tea egg
moon guitar	yueqin
mesencephal	mesencephalon
Moody diagram	Moody chart
monk vulture	Eurasian black vulture
multicultural Marxism	cultural Marxism
mushroom cut	bowl cut
multigraded	multigrade
macrogamont	macrogametocyte
monometrical	monometric
MGCC	MVCC
macrophiliac	macrophile
mesopelagial	mesopelagic
megapolitan	megapolis
Mu'tazilite	Mu'tazila
meander	Greek key
medal play	stroke play
microribonucleic acid	microRNA
myeloerythropoiesis	erythropoiesis
Menkes syndrome	Menkes disease
mycocide	fungicide
mutant	mutex
metaquartzite	quartzite
mistbow	fogbow
mechanistics	mechanism
methodistical	methodistic
midprice	midrate
mandrix	mandies
maleinanhydride	maleic anhydride
mountain wolf	dhole}}
mitigating circumstances	extenuating circumstances
multivalvar	multivalvular
multiple dispatch	function overloading
mad cow disease	bovine spongiform encephalopathy}}
Mayer-Rokitansky-Küster-Hauser syndrome	Müllerian agenesis
messenger pigeon	homing pigeon
milRNA	microRNA
marenostrin	pyrin
mailsack	mailbag
mercenaryism	mercenarism
macronova	kilonova
monodisperse	uniform
mechanistical	mechanistic
multiphaser	polyphaser
mad as a brush	daft as a brush
maikong	crab-eating fox
manlihead	manlihood}}
meniscocyte	sickle cell
Moffatt oxidation	Pfitzner-Moffatt oxidation
microhydro	microhydropower
mathree	matatu
Madagascar sea-eagle	Madagascan fish eagle
marble cake federalism	cooperative federalism
micropinocytosis	pinocytosis
misappellation	misnomer
methylbenzene	toluene
maladaptative	maladaptive
methodologic	methodological
metretes	metrete
misjustice	injustice
Moschcowitz syndrome	thrombotic thrombocytopenic purpura
muscatorium	flabellum
moribundancy	moribundity
macrosatellite	satellite DNA
monomethylamine	methylamine
mirror twin	mirror-image twin
migratory bird	bird of passage
monosugar	monosaccharide
mesenterial	mesenteric
mistella	mistelle
member country	member state
multiton pattern	multiton
momhood	motherhood
microraptorine	microraptorian
mesorostrine	mesorostral
medialwards	medialward
maledight	malediction
megaphagia	polyphagia
marmelosin	imperatorin
mahawar	alta
middlebreaker	middlebuster
mudirate	mudiriyah
mesenchymatous	mesenchymal
megatooth	megalodon
make a joke of	make light of
mellow yellow	bananadine
monoacylglycerophospholipid	lysophospholipid
merit badge college	merit badge university
methyl vinyl ketone	butenone
monocarboxypeptidase	carboxypeptidase
monotheistical	monotheistic
monoclinate	monoclinic
moss saxifrage	mossy saxifrage
microevolutional	microevolutionary
matrimony vine	wolfberry
moral duty	moral obligation}}
myofascial decompression	cupping}}
mesopodium	petiole
magazette	diskzine
model-driven testing	model-based testing
Merc	Mercedes-Benz
meta-universe	multiverse
metamystical	metamystic
multivolumed	multivolume
mushroom haircut	bowl cut
Marxist-Leninism	Marxism-Leninism
monostele	protostele
molybdophosphoric	phosphomolybdic
Martha Washington geranium	regal geranium
millennianism	millenarianism
microcephalism	microcephaly
meteoritic iron	meteoric iron
message-driven architecture	event-driven architecture
misogynistical	misogynistic
magnetooptic	magnetooptical
multiloquious	multiloquent
monoliteral	monographic
muricated	muricate
moon facies	moon face
mucoglycoprotein	mucoprotein
Madagascar fish eagle	Madagascan fish eagle
medioccipital	midoccipital
monoglyme	dimethoxyethane
mancake	beefcake
mustimeter	saccharimeter
multiflagellar	multiflagellate
manual work	manual labor
multinucleosis	polynucleosis
Maccabi	Maccabee
malvoisie	malmsey
microflat	microapartment
make both ends meet	make ends meet
middot	interpunct
myocardiac	myocardial
masculinazi	masculinist
mephitic acid	carbonic acid
macrothermal	megathermal
mumijo	shilajit
monopedal	unipedal
metalloscopy	metallotherapy
miph	mph
monoplex	simplex
monofoliate	unifoliate
matrin	matrilysin
matboard	mountboard
methylenimine	azomethine
monomorph	unimorph
monastery cheese	Trappist cheese
metakinetism	metakinesis
moon bounce	bouncing castle
matoppie	motlopi
manicottis	manicotti
mazodynia	mastodynia
merogeny	merogenesis
monopotent	unipotent
mallotoxin	rottlerin
macrodactylism	macrodactyly
melitose	raffinose
monged out	monged
mudcloth	bogolan
myxococcal	myxobacterial
marimbaist	marimbist
mesostable	metastable
mycostatin	nystatin
monopolymer	homopolymer
microinfarction	microinfarct
mahogany lung	woodworker's lung}}
monocracy	autocracy
mineral turpentine	white spirit
made-for-television	made-for-TV
metatile	supertile
microbiologic	microbiological
misty-eyed	dewy-eyed
mandoliner	mandolinist
member field	member variable
macro guard	include guard
motor vessel	motor ship
machos	machismo
moon zither	yueqin
mermaid's toenail	jingle shell
molybdophosphate	phosphomolybdate
murder one's darlings	kill one's darlings
mono-ene	monoene}}
marshalcy	marshalship
metabase	metadatabase
march to a different beat	march to the beat of a different drum
micromillimeter	nanometer
Mennonist	Mennonite
methylsulfonate	methanesulfonate
monomyeloid	myelomonocytic
mediastinic	mediastinal
monoacylglyceride	monoglyceride
mononom	mononym
metatrochanter	metafemur
miniabortion	minisuction
mooli	daikon
mercaptoethane	ethyl mercaptan
multisensorial	multisensory
multiplicator	multiplier
Mickey Mouse hat	Mickey Mouse cap
mindswap	bodyswap
markspersonship	marksmanship
magwinya	vetkoek
Marcionist	Marcionite
malappropriate	misappropriate
monkey about	monkey around
melancholiac	melancholic
monachist	monastic
molybdenate	molybdate
mudspate	mudflow
mittel	English
Makhnovite	Makhnovist
martial	Martian
medicinal finger	medical finger
merge sort	mergesort
mimetesite	mimetite
moss piglet	water bear
mellitoxin	hyenanchin
matriarchism	matriarchy
mechanographical	mechanographic
Mfengu	Fengu
mesokinetism	mesokinesis
method overloading	function overloading
marconi operator	wireless operator or radio operator}}
multisyllable	polysyllable
monogenoidean	monogenoid
Mician	Mohist}}
nitrodilator	nitrovasodilator
needle phobia	trypanophobia
nomadical	nomadic
noun substantive proper	proper noun
Natal boil	Aleppo boil
neuroglucopenia	neuroglycopenia
nosyl	nitrobenzenesulfonyl
nucleus ruber	red nucleus
nanoinformatics	nanocomputing
nightingale floor	uguisubari
nesosilicate	orthosilicate
nesiotic	nesiote
nepit	nat
nebbisher	nebbish
norflaxin	norfloxacin
neuroexcitotoxic	excitotoxic
nonclaim statute	statute of repose
neck eel	longneck eel
nau	carrack
nonbraced	unbraced
Newtonism	Newtonianism
nimbyist	nimby
near shave	close shave
nonsynchronised	unsynchronised
nonbiologic	nonbiological
Newgate frill	Newgate fringe
necrozoospermia	necrospermia
neuroexcitotoxicity	excitotoxicity
nesting box	nest box
nembutal	pentobarbital
nameless bee disease	disappearing disease
noctilucoid	noctilucous
nagoonberry	arctic raspberry
non-empirical ego	transcendental ego
neoglucogenesis	gluconeogenesis
naphthyridin	naphthyridine
nucleon number	mass number
neurosome	perikaryon
necktie social	necktie party
no one's fool	nobody's fool
nipagin	methylparaben
neovasculation	neovascularization
neuroterminal	end organ
native ground	native soil
netlinguistics	cyberlinguistics
Negro spiritual	spiritual
neb-neb	bablah
northly	northerly
nambas	namba
Nazi Shepherd	German Shepherd
neger	nigger
Norfolk rotation	Norfolk crop rotation
neo-Bolshevist	neo-Bolshevik
neurogliocyte	glial cell
neural axis	cerebrospinal axis
negrophilist	negrophile
nonapology apology	non-apology
Nazorean	Nazarene
nontransplanted	untransplanted
need one's bumps feeling	need one's head examined
not know whether to spit or go blind	not know whether to shit or go blind
nickel tour	fifty-cent tour
neogeneration	neogenesis
necessarium	reredorter
Norfolk pine	Norfolk Island pine
nyami	name
nonpareille	nonpareil
nail fungus	onychomycosis}}
ninja sword	katana}}
nurnie	greeble
niccolite	nickeline
name-based type system	nominative type system
nearabouts	nearabout
neurodepressive	neurodepressant
net loss	net operating loss
nullipar	nullipara
nonbylined	unbylined
neoplasmatic	neoplastic
nephropyosis	pyonephrosis
neuromediator	neuromodulator
Native American giver	Indian giver
namé	name
neuroglioma	ganglioglioma
nitrogen tetroxide	dinitrogen tetroxide}}
nerve agent	nerve gas
Nige	Nigel
n-propanol	1-propanol
normocarbia	normocapnia
nucleophosphatase	nucleotidase
neoclassicalism	neoclassicism
nephropathia	nephropathy
nodding thistle	musk thistle
Newtonist	Newtonian
neuromedicine	neurology
neo-Pentecostal	neo-charismatic
neurotrophism	neurotrophy
neurodegenerescence	neurodegeneration
nonsense syndrome	Ganser syndrome
no-tell hotel	no-tell motel
nonambulant	nonambulatory
numbnut	numbnuts
nested class	inner class
northermost	northernmost
Newa	Newar
novella	novel
neurosensorial	neurosensory
nyctinastism	nyctinasty
nigger in the fence	nigger in the woodpile
nomenclaturalist	nomenclaturist
native land	native soil
nonadherer	nonadherent
netherwards	netherward
Nebty name	Two Ladies name
nitrocotton	nitrocellulose
N-acetyl-p-aminophenol	para-acetylaminophenol}}
nitriloacetate	cyanoformate
nominal type system	nominative type system
newfounded	newfound
nitrophilic	nitrophilous
not anymore	no longer}}
new jack	new jack swing
nigger-rig	jury-rig
northern spell	trap ball
nerdwear	geekwear
neurodystonia	dystonia
nitratite	nitratine
nitpickety	nitpicky
navel-watching	navel-gazing
nephelite	nepheline
notalian	subantarctic
nyctitropism	nyctinasty
nigger-rigged	jury-rigged
nail it	hit the nail on the head
nucleosomic	nucleosomal
NIMBY	nimby
naphthopyranone	naphthopyrone
neck and heels	neck and crop
Nubian lion	East African lion
nictitant	nictitating
nectivore	nectarivore
nerdly	nerdy
New Zealand sassafras	pukatea
Napoleon syndrome	Napoleon complex
NBOMe	25I-NBOMe
Nonne-Milroy-Meige syndrome	Milroy's disease
navicular abdomen	scaphoid abdomen
neurophysiologic	neurophysiological
neurocrest	neural crest
nek	col
nook and corner	nook and cranny
nonylaldehyde	nonanal
noncaged	uncaged
neural net	neural network
nicky-nicky-nine-doors	knock down ginger
noncharacterized	uncharacterized
note payable	promissory note
nosogeny	nosogenesis
nameless finger	ring finger
newspapery	newspaperish
neuroependyma	ependyma
neato burrito	neato
necromant	necromancer
nieshout	sneezewood
neknominate	neknomination
nail-tail wallaby	nailtail wallaby
normethisterone	normethandrone
naturehood	nature
neuroprotecting	neuroprotective
New York strip	strip steak
nocisensor	nociceptor
neu	HER-2
nectivorous	nectarivorous
nonsubmittal	nonsubmission
nipsy	trap ball
nepiophilia	infantophilia
noematical	noematic
ñame	name
pseudo-borrowing	false borrowing
premeiosis	mitotis
protectant	protective
Philistian	Philistine
Patriot	Patriote}}
pine kernel	pine nut
papillotubular	tubulopapillary
plumptitude	plumpness
peal of bells	ring of bells
propyl alcohol	1-propanol
pure collector	pure finder
phenoconversion	phenocopying
paludic	malarial
Pullman car	Pullman
pinspotting	pinsetting
pastry shop	patisserie
piece up	patch up
peppermint stick	candy cane
portgreve	portreeve
permanent revolutionist	permanent revolutionary
pro-birth	pro-life
pityriasis versicolor	tinea versicolor
placentotrophy	matrotrophy
podzoluvisol	albeluvisol
polymasty	polymastia
peace silk	ahimsa silk
pressman's hat	printer's hat
pinch-me-round	gizzada
prison break	jail break}}
phone-in show	call-in show
pegasse	peat
poikilohydrous	poikilohydric
perimortal	perimortem
patupilone	epothilone
presupplemental	presupplementary
punditical	punditic
Pythonish	Pythonesque
Pareto efficiency	Pareto optimality
politricking	politricks
pizza guy	pizza man}}
principle of substitutivity	indiscernibility of identicals
Pfeiffer's glandular fever	glandular fever
point of articulation	place of articulation
postextractional	postextraction
phonotactical	phonotactic
play the deuce with	play the devil with
period of time	time period
psychoacoustical	psychoacoustic
pictophonetic	phonosemantic
phosphotransacetylase	phosphate acetyltransferase
paracaine	proparacaine
photoirritancy	photoirritation
polar bear dip	polar bear plunge
post-office order	postal order
package saver	pizza saver
protopectin	pectose
phosphonucleotide	nucleotide
pathohistology	histopathology
perispheric	perispherical
pib	pibgorn
pour fuel on the fire	add fuel to the fire
phosphomannose	mannose phosphate
pepper-gas	pepper spray
pssh	pshaw
pour out one's soul	pour one's heart out
pasta fazool	pasta e fagioli
popular music	pop music
pitarrilla	balché
primary work	primary source
pease pottage	pease pudding
put to lie	give the lie to}}
polyphotal	polyphote
palaeomastology	palaeomammalogy
pseudocoelom	pseudocoel
preponderately	preponderantly
pibcorn	pibgorn
pseudomurein	pseudopeptidoglycan
pick-and-pick	pick-at-will
phenocrystal	phenocryst
photometrical	photometric
paleohistory	archaeology
poserish	poseurish
platitudeness	platitude
ptilocerque	pen-tailed treeshrew
psychotronics	parapsychology
plastic wood	wood putty
primitive colour	primary colour
powder room	half bath
play to the cheap seats	play to the gallery
prison base	prisoners' bars
postcoitum	postcoital
pen portrait	pen picture
plainchant	plainsong
paratergite	laterotergite
ppongjjak	trot
put one's head in the sand	bury one's head in the sand
pathopoiesis	pathogenesis
peptiglycan	peptidoglycan
phosphoacylase	phosphate acetyltransferase
psychological slip	Freudian slip
polyoxybenzylmethylenglycolanhydride	Bakelite}}
pink bunny	blushing bunny
photobiliprotein	biliprotein
partograph	partogram
play the dickens with	play the devil with
psychrophilous	psychrophilic
pluriverse	multiverse
polysynthetism	polysynthesis
pentatope	pentahedron
prusside	cyanide
pity potty	pity pot
plaguish	plaguy
play the giddy goat	act the goat
pancryptodiran	cryptodiran
programming by contract	design by contract
paratumoral	paraneoplastic
protonize	protonate
postphagocytic	postphagocytosis
paratactical	paratactic
polygrammoid	polypod
pour dogs and cats	rain dogs and cats
parakinesia	parakinesis
pony truck	Bissell truck
prick tease	cock tease
Permanent Sexual Arousal Syndrome	persistent genital arousal disorder
put the lie to	give the lie to}}
pistosaurian	pistosaurid
plurinucleated	multinucleated
philanthropism	philanthropy
pyridylbenzene	phenylpyridine
pontoniid	pontoniine
podosol	spodosol
put one's best foot foremost	put one's best foot forward
polyhistoric	polyhistorical
postembryonal	postembryonic
propshaft	propeller shaft
Pauling	Pauling unit
photospectrophotometer	spectrophotometer
paraedrite	rutile
palynologic	palynological
petit final	small final}}
phosphorodithioate	dithiophosphate
Phariseeism	pharisaism
pigeon fancier's lung	bird fancier's lung
photoevolve	photoemit
phospholidine	phospholane
party potatoes	funeral potatoes
psychotechnics	psychotechnology
pillar harp	frame harp
prochordate	protochordate
premetaphase	prophase
plasmavore	hemovore
pseudo force	fictitious force
polyonymosity	polyonymy
patriotically correct	conservatively correct
paradox of saving	paradox of thrift
play to the crowd	play to the gallery
play the goat	act the goat
paroquet auk	parakeet auklet
panaxoside	ginsenoside
primitive wrapper class	wrapper
pinspotter	pinsetter
philosophy	small pica
pastrix	pastoress
presocialist	utopian socialist
pomarine jaeger	pomarine skua
pluperfect	multiperfect
photo paper	photographic paper
periselene	pericynthion
paralophid	paracristid
plasma gem	plasma gemstone}}
parenchymatic	parenchymatous
phisnomy	physiognomy
prolixin	fluphenazine
painted bug	bagrada bug
precategory	semigroupoid
pirate shirt	poet shirt
paratransgenics	paratransgenetics
paella pan	paellera}}
propenylphenol	phenylpropene
premonocyte	promonocyte
phenylethylacetylurea	pheneturide
parulis	gumboil
paramesonephrotic	paramesonephric
pastry cook	pastry chef
primus motor	primum mobile
policy pattern	strategy pattern
phlyctis	phlyctidium
pfeffernusse	pfeffernuss
pourquoi tale	pourquoi story
pretzel style	Indian style
pizza wheel	pizza cutter}}
Piccadilly weepers	dundrearies
pelagial	pelagic
prey upon	prey on
pyrogenetic	pyrogenic
pinacone	pinacol
polar bear swim	polar bear plunge}}
pukehole	shithole
protectible	protectable
prodnose	busybody
panino	panini
plasmoquine	chloroquine
phenoxetol	phenoxyethanol
preterition	paralipsis
potty-trained	toilet-trained}}
palmilla	sacahuista
pop-rock	pop rock
pedal steel	pedal steel guitar
pseudogley	stagnosol
photomixotrophically	mixotrophically
paracrinal	paracrine
polydactyly	polydactylism
peer-to-peer economy	sharing economy
parasigmatism	sigmatism
provasopressin	copeptin
pluralistical	pluralistic
purpuriparous	purpuriferous
poor as a rat	poor as a church mouse
piss bottle	pee bottle
psammophobic	psammoxenic
perplex number	split-complex number
pork floss	rousong
paravascular	glymphatic
pan-Amerindianism	pan-Indianism
planet-stricken	planet-struck
perinigricon	peribothron
pianoist	pianist
pistol furniture	gun furniture
para ice hockey	sledge hockey}}
pianica	melodica
pep pill	party pill
project evaluation review technique	program evaluation and review technique
pipfruit	pome
parasynchronized	parasynchronous
pit babe	grid girl
phosphorylceramide	sphingomyelin
pilomatricoma	pilomatrixoma
psychoplasticity	neuroplasticity
pullout	liftout
philosophic	philosophical
pop fastener	snap fastener
plurifactorial	multifactorial
precipitative	precipitate
put through the mangle	put through the wringer
psht	shh
paradon	baryton
paper scissors stone	rock paper scissors
photomixotrophic	mixotrophic
passport baby	anchor baby
patio dress	squaw dress
Papanicolaou test	Pap test
pseudograin	pseudocereal
periamygdalar	periamygdaloid
Plimsoll mark	Plimsoll line
pompadour fish	discus fish
psychiatrical	psychiatric
period drama	period piece}}
Penrose mechanism	Penrose process
Prince Rupert's tear	Rupert's drop
pyrenomycete	sordariomycete
pentamethylene	cyclopentane
Pope's Pear	choke pear
precortex	prefrontal cortex
pointilliste	pointillist
paper bin	wastepaper basket
plesiosaurus	plesiosaur
postregulational	postregulation
pyodermitis	pyoderma
police dog	German shepherd
prebiologic	prebiological
phone card	telephone card
phytomediation	phytoremediation
punch block	punchdown
pet store	pet shop
Puerto Rican syndrome	ataque de nervios
plurality rule	first past the post
pisalis	calefactory
playworthy	playable
phraseograph	phraseogram
pease porridge	pease pudding
photoretinoscope	retinoscope
poet blouse	poet shirt
ploussard	poulsard
polyvoltine	multivoltine
perisylvic	perisylvian
postvoiding	postvoid
phalansterianism	phalansterism
pizza oven	conveyor oven}}
Prince Rupert's drop	Rupert's drop
pomatorhine skua	pomarine skua
pycnospore	stylospore
prefemur	ischiopodite
parawing	Rogallo wing
perroquet auk	parakeet auklet
picaridin	icaridin
potence	crutch
Puritan work ethic	Protestant work ethic
poetical	poetic
predictant	predictor
ploughland	carucate
potender	budtender
paving tile	floor tile
polyclonal	polyclonal antibody
parenthesis-point	parenthesis
preteener	preteen
polydisperse	nonuniform
polyhelicene	helicene
photomorphology	photomorphogenesis
postchroming	afterchroming
philosophical furnace	athanor
postanalysis	postanalytical
purity pledge	virginity pledge
paraglobin	paraglobulin
piratey	piratelike
protonization	protonation
prison wine	pruno
paralytic dementia	general paresis of the insane
polymyxin E	colistin}}
plasmidal	plasmidial
pornorific	pornographic
propenoic acid	acrylic acid
protoplanetesimal	protoplanetary
previtamin	provitamin
patron	patron saint
prince's plume	prince's feather
paraform	paraformaldehyde
profanity delay	broadcast delay
papalism	papism
pericartilage	perichondrium
proatherosclerosis	proatherosclerotic
polytelite	freibergite
poky bonnet	poke bonnet
piggy flu	swine flu}}
presocialism	utopian socialism
parabrake	drag parachute
Persophobia	Iranophobia
prosome	proteasome
prawn toast	shrimp toast
parakeet auk	parakeet auklet
pterygopalate	pterygopalatine
primary healthcare	primary care
perspectivization	perspectivation
parahockey	sledge hockey}}
peritrack	taxiway
Pecksniffianism	Pecksniffery
parabasalian	parabasalid
permanent revolutionary	Trotskyist
phagedenic gingivitis	acute necrotizing ulcerative gingivitis
palaver hut	toguna
primperan	metoclopramide
polycombustible	multicombustible
pararhotacism	rhotacism
photographic	accurate
prospermatogonium	gonocyte
plushie	plush toy
plain-speaking	plain-spoken
plurivalent	multivalent
palpiferous	palpigerous
purple rice	black rice
pole up one's ass	stick up one's ass
pontonnier	pontooner
preformist	preformationist
pavement cafe	sidewalk cafe
phenylmethane	toluene
palatosphenoidal	palatovaginal
polyphilia	polyamory
pick gooseberry	play gooseberry
put in motion	set in motion
periodontic	periodontal
plurinucleate	multinucleate
polar wolf	Arctic wolf
pelviotomy	symphysiotomy
pump and jump	gas and dash
pour cold water on	throw cold water on
pentuplicate	quintuplicate
poor man's Tiffany	carnival glass
pork sung	rousong
philosopher's lamp	Döbereiner's lamp
pleiomorphy	pleomorphism
protosun	protostar
prison psychosis	Ganser syndrome
Philonian conditional	material conditional
patriotic correctness	conservative correctness
posterograde	retrograde
promise the earth	promise the moon}}
phytotreatment	phytoremediation
paracitidal	paracytic
provisional license	learner's permit
polyvinylic	polyvinyl
pre-sequel	prequel
prenuptial	prenuptial agreement
prosodiacal	prosodic
phytogenetical	phytogenetic
paragammacism	gammacism
praetorial	praetorian
pommecythere	ambarella
purulosanguineous	purulosanguinous
phyllo pastry	phyllo
protopod	protopodite
PV number	Pisot-Vijayaraghavan number
polyethyleneoxide	polyethylene glycol
paratumour	paraneoplasia
project evaluation and review technique	program evaluation and review technique
piaiman	piai
pipe snake	plumber's snake
power couple	supercouple
palang	ampallang
plum tom	plum tomato
polynucleic acid	polynucleotide
Pisot number	Pisot-Vijayaraghavan number
photofrin	porfimer sodium
persistent sexual arousal syndrome	persistent genital arousal disorder
pustie	pasticciotto
profibrosis	profibrotic
pheresis	apheresis
partetravirus	tetraparvovirus
prosperity gospel	word of faith}}
perisaturnium	perikrone
planetical	planetary
penny university	coffee shop or coffeehouse
peener	penis
pollist	pollster
pickle up one's ass	stick up one's ass
phosphorofluoridate	fluophosphate
polydatin	piceid
pillowside	bedside
pseudocopula	semicopula
poop sandwich	shit sandwich
production means	means of production
prefigation	prefixation
physically unclonable function	physical unclonable function
preclimacteric	premenopausal
pavement chalk	sidewalk chalk
paraspinous	paraspinal
polypyrrolidone	polyvinylpolypyrrolidone
photobiologic	photobiological
pyrophosphotransferase	pyrophosphokinase
pharmorubicin	epirubicin
podobranchia	podobranch
Pennsylvania rifle	Kentucky rifle
polyglycol	polyethylene glycol
print-friendly	printer-friendly
principle of verifiability	verifiability principle
pour cats and dogs	rain cats and dogs
piezooptical	piezooptic
plutocratical	plutocratic
polyhistorian	polyhistor
pantun	pantoum
pseudoazurin	cupredoxin
political correction	political correctness
people's warrior	Maoist
palmetoic	palmitoleic
photomovement	phototaxis
puboischial	ischiopubic
PBB	jet bridge}}
Polonian	Polonial
professional university	university of applied sciences
penal officer	prison officer
politrickery	politricks
pull the wires	pull strings
Polish sausage	kielbasa}}
pocket CD	mini CD
pectinibranchial	pectinibranchiate
permitable	permissible
paraphylactic	anaphylactic
prethalamus	subthalamus
premedicine	pre-med
plunket	blunket
pull-on	slip-on
purging	purgation
peace in our time	peace for our time
packing noodle	packing peanut
pork out	blimp out
polylactate	polylactide
pathognostic	pathognomonic
posteriolateral	posterolateral
peritumorous	peritumoral
pantisocratical	pantisocratic
phonophotophobia	photophonophobia
pear cider	perry}}
postclimacteric	postmenopausal
pshht	pshaw
promise ring	purity ring
panspermism	panspermatism
pear wine	perry}}
phenyloxy	phenoxy
pleuracentesis	thoracentesis
pentaspan	pentastarch
positive assortative mating	assortative mating
podotactile	pedotactile
paragogical	paragogic
penthemim	penthemimeris
pernio	chilblain
pareiasaurid	pareiasaur
pluridisciplinary	multidisciplinary
pondimin	fenfluramine
pssht	pshaw
play merry hell with	play the devil with
polycropping	polyculture
physician finger	medical finger
precommissure	anterior commissure
peace be with you	farewell
persecutorial	persecutory
photoevolution	photoemission
psychoendoneuroimmunology	psychoneuroimmunology
pure ego	transcendental ego
portgrave	portreeve
plumbing snake	plumber's snake
pyelon	renal pelvis
perchloroethylene	tetrachloroethene
paratumorous	paraneoplastic
phytopathologic	phytopathological
pipecolinic	pipecolic
prosecutee	defendant
photoconducting	photoconductive
psychoneuroendocrinoimmunology	psychoneuroimmunology
pochette	kit violin
perhydroxyl	hydroperoxyl
POW camp	prisoner-of-war camp
pubiotomy	symphysiotomy
paraphosphate	pyrophosphate
Pindarical	Pindaric
phytomenadione	phylloquinone
peristaltism	peristalsis
phenicol	chloramphenicol
plumber's friend	plumber's helper
plane ticket	air ticket
put one's toe in the water	test the waters
passionate friendship	romantic friendship
procreater	breeder
percussed	percussant
prasiolite	vermarine
pepper gas	pepper spray
postmeiosis	postmeiotic
presidiary	presidial
photospectrometer	spectrophotometer
parka squirrel	arctic ground squirrel
pocket T	pocket T-shirt
put lie to	give the lie to}}
phosphonoglycerol	glycerophosphoric acid
periost	periosteum
plain point	full stop
pathological coupling	content coupling
pyjama party	slumber party
porphyrogene	porphyrogenite
paradoxally	paradoxically
proactivity	proactiveness
post-factual	post-truth
pakbet	pinakbet
put-back	go-back
paraquadrate	squamosal
peteman	peterman
pectinibranchous	pectinibranchiate
pyrolization	pyrolysis
phosphoryltransferase	phosphotransferase
pseudoaldosteronism	pseudohyperaldosteronism
Pres.	Pres
probiont	protobiont
psycho-biddy	hagsploitation
Plaut-Vincent angina	acute necrotizing ulcerative gingivitis
port-wine stain	naevus flammeus
powerful	very
person-made	man-made
piped music	background music
piece of crap	piece of shit
public health funeral	pauper's funeral
pregnacalciferol	hydroxycholecalciferol
psychobiologic	psychobiological
prepilin	prepilin peptidase
Purkinje neuron	Purkinje cell
ponderosa pine	ponderosa
pregnanedione	dihydroprogesterone
pedagogic	pedagogical
paper punch	hole punch
paralambdacism	lambdacism
psychopathologic	psychopathological
parabolic cup	mastos
Palaeodicotyledons	paleodicots
popcorn film	popcorn movie
pouch of Morison	Morison's pouch
philopolemical	philopolemic
plagiarization	plagiarism
pour one's soul out	pour one's heart out
principle of verification	verifiability principle
pygmy chimpanzee	bonobo}}
pierogi pizza	pagash}}
postconfluency	postconfluent
quadracycle	quadricycle
Qin script	small seal script
Queenite	Emmaite
QWERTYUIOP	qwerty
quadriforce	four-force
quasiballistic	semiballistic
quaternary healthcare	quaternary care
quasianalytical	quasianalytic
quog	quahog
quadrigeminate	quadrigeminal
quantum jump	quantum leap
quadriacceleration	four-acceleration
Queen's hard bargain	one of His Majesty's bad bargains
quadrivector	four-vector
quinol	hydroquinone
quadrivalency	quadrivalence}}
quadrivelocity	four-velocity
quinomycin	echinomycin
question of time	matter of time
quiet as a snowflake	silent
quad rugby	wheelchair rugby}}
quick water	quicksilver water
Q-boat	Q-ship
quantistic	quantum
road picture	road movie
reitbok	reedbuck
racing form	scratch sheet
rhinopharynx	nasopharynx
risperdal	risperidone
radioimmune	radioimmunological
revealed check	discovered check
return to one's senses	come to one's senses
reviviscency	reviviscence
retinograph	retinogram
run to ground	run to earth
ready to be tied	fit to be tied
rehymenate	revirginate
Rural Gothic	Carpenter Gothic
rotavape	rotary evaporator
roset	rosin
religist	religious
royal stremma	stremma
red neck syndrome	red man syndrome
ridicule pole	shame pole
rabbit in the headlights	deer in the headlights
Rube Goldberg	Rube Goldberg machine
race realism	scientific racism
rondino	rondoletto
rear-vision mirror	rear-view mirror
ruling grade	ruling gradient
rainscreen	rainshade
recover one's senses	come to one's senses
running of the bulls	bull run
ringlight	ringshine
rhus juice	sumacade
reticency	reticence
radargram	radar chart
rabip	rabeprazole
Rendu-Osler-Weber disease	Osler-Weber-Rendu disease
ribeye	ribsteak}}
RNA expression pattern	RNA expression profile
ricinic acid	ricinoleic acid
reactionism	reactionaryism
Romantic	Romance
reflexive	reflective
ripicolous	riparian
roseheart radish	watermelon radish
Richardson's owl	Tengmalm's owl
radiosymmetry	radial symmetry
rakehelly	rakehell
rear projection	back projection
ruanqin	ruan
red daikon	watermelon radish
rectoscopy	proctoscopy
rightsowner	rightsholder
Rhodesian redwater fever	redwater fever
Rorschach inkblot test	Rorschach test
rave hook	ripping iron
reboring	rebore
riverwards	riverward
rosy pastor	rosy starling
resistomycin	heliomycin
reckon upon	reckon on
raag	raga
roaring boy	roarer
rose-coloured starling	rosy starling
rudosol	entisol
renew	renewal
Richard Roe	John Doe}}
runaway selection	Fisherian runaway
restiad	restio
renotoxic	nephrotoxic
red admirable	red admiral
revolver	revolving line of credit}}
Rosenthal effect	Pygmalion effect
road spikes	spike strip
retrofracted	retrofract
reasonous	reasonable
Rafidhite	Rafidhi
radiozoan	radiolarian
ratitate	ratite
remaster	remastering
renal cast	urinary cast
rooster booster	chicken cannon
Rastafarist	Rastafarian
rugosan	rugose
Rhadamanthean	Rhadamanthine
Russian salad	Olivier salad
radiochemoresistance	chemoradioresistance
red snow	watermelon snow
recombinatory	recombinatorial
red meat radish	watermelon radish
roll in dough	roll in wealth
red ape	orangutan
renal cylinder	urinary cast
remodel	remodeling
roentgenologic	roentgenological
radiochemoresistant	chemoradioresistant
rich client	fat client
Rupert's tear	Rupert's drop
rise to the bait	take the bait
rosein	fuchsine
rotavap	rotary evaporator
raphidophycean	raphidophyte
rattle someone's chain	rattle someone's cage
ring singularity	ringularity}}
renoprotective	nephroprotective
returnal	return
refreshedness	refreshment
rainbow glass	carnival glass
ruddy diver	ruddy duck
retroorbitary	retroorbital
ride the cotton bicycle	ride the cotton pony
reconstellation	regrouping
Ritscher-Schinzel syndrome	3C syndrome
redruthite	chalcocite
rangerine	rangiferine
renarrowing	restenosis
relative pressure	gauge pressure
rum baba	baba au rhum
ride the cotton horse	ride the cotton pony
randy mandies	mandies
Rhodesian fever	redwater fever
read someone for filth	read someone to filth
rubbing alcohol	isopropanol
rec league	beer league}}
rhetoric	rhetorical
ring singularities	ringularities}}
rheofluidification	thixotropy
radiobiologic	radiobiological
rationalistical	rationalistic
rare animal	rare bird
rock mouse	rock rat
ring of the fisherman	piscatory ring
roach stomper	roach killer
resource officer	school resource officer
redundantant	redundant
rhizocarpic	rhizocarpous
regain one's senses	come to one's senses
rustle someone's jim-jams	rustle someone's jimmies
rumberry	guavaberry
ruby silver	pyrargyrite
resorcin	resorcinol
ribosomal ribonucleic acid	ribosomal RNA}}
retroperfusion	retrograde perfusion
Remoboth	Sarabaite
rock garden	rockery}}
rock rabbit	klipdachs
rubble drain	French drain
red pussy hair	red cunt hair
rotoevaporator	rotary evaporator
regiodiverse	regiodivergent
ring silicate	cyclosilicate
road film	road movie
registry office	register office
ribbon worm	proboscis worm
red packet	red envelope
raphidoflagellate	raphidophyte
rachial	rachidial
racehorse goanna	sand goanna
reiterate oneself	repeat oneself
rhizopodium	rhizopod
remote surgery	telesurgery
riboprotein	ribonucleoprotein
retozide	isoniazid
ride rusty	turn rusty
rum deal	raw deal
rheumatical	rheumatic
ribauldequin	organ gun}}
red flag to a bull	red rag to a bull
resultativeness	resultativity
renninogen	prochymosin
rolling in dough	rolling in it
road hump	speed bump and speed hump
rough pump	roughing pump
reredundant	redundant
roller sled hockey	roller sledge hockey}}
Rehobother	Baster
rose-coloured pastor	rosy starling
transuteral	transuterine
toll barrier	tollbar
tinker's toot	tinker's damn
teething problems	teething troubles
twistie	latticino
triple A	AAA
tiller-beam	tail-pole
throw in the sponge	throw in the towel
today's flavor	flavor of the week
teleportational	teleportative
triethylboron	triethylborane
Tourette's	Tourette syndrome
table steel	table steel guitar
tone color	timbre
trabeate	trabeated
third-class citizen	third-class object
tinner's snips	tin snips
Turkicization	Turkification}}
talking book	audiobook
toilet jack	plumber's snake
tagging interface	marker interface
trombone-player	trombonist
tassology	tasseography
trabecularization	trabeculation
top to tail	head to toe
top cat	top dog
true to one's word	good as one's word
Turkey hone	Turkey stone
tuberositas	tuberosity
trepanomatosis	treponemiasis
teahouse	tearoom
tryworks	trywork
telopodite	basipodite
trachelian	cervical
take one's seat	take a seat
telonism	telonym
to start with	to begin with}}
thiyl	sulfenyl
thermal mass	heat capacity
telenewspaper	telepaper
tiang	korrigum
throw in the cards	throw in the towel
tert-butyl	tertiary butyl}}
tarfile	tarball
tearabout	tearaway
thick-crust pizza	deep-dish pizza}}
thought shower	brainstorming
tag line	dialogue tag
toxic syndrome	toxic oil syndrome
techpreneur	technopreneur
tran	transperson
telecardiography	electrocardiography
toppoki	tteok
time attack	time trial
tobacco beetle	cigarette beetle
tape delay	broadcast delay
trouble causer	troublemaker
Tatarian	Tartarian
tree oyster	oyster mushroom
take issue to	take issue with
tertbutyl	tertiary butyl}}
Townsend avalanche	Townsend discharge
third-class entity	third-class object
tinner snips	tin snips
thermocol	polystyrene
two-port network	quadripole
tax avoision	avoision
taxotere	docetaxel
Thanksgiving Thursday	Thanksgiving Day}}
trisegmentectomy	trisectionectomy
toasting-iron	toasting-fork
thank goddesses	thank the goddesses
thermonuclear bomb	thermonuclear weapon
Thai boxing	Muay Thai
trispaston	trispast
tumbleset	somersault
tidal mill	tide mill}}
translady	transwoman
tip sheet	scratch sheet
trituberculism	trituberculy
tangi	tangihanga
tagete	tagetes
tetraoxosilicate	orthosilicate
ticket vending machine	ticket machine
theobromide	theobromine
theriology	mammalogy
townfolk	townsfolk
triperiden	norakin
transport safety board	transportation safety board
throat singing	overtone singing
tungstophosphoric	phosphotungstic
Tabata	Tabata method
Tipler machine	Tipler cylinder
tocography	cardiotocography
town bike	town bicycle
talk aloud protocol	think aloud protocol
toxicness	toxicity
trigintennial	tricennial
toilet teaching	toilet training
to be fair	in fairness
tooth fungus	hydnoid
tadeonal	polygodial
temporozygomatic	zygomaticotemporal
trunk breeches	trunkhose
talk jock	talk jockey
tropical sweet potato	name
tumbling E chart	E chart
two men and a dog	one man and his dog
trucking shot	tracking shot
tetrahydropapaveroline	norlaudanosoline
think with one's penis	think with one's little head
traffic bump	speed bump
tylopodan	tylopod
tinniolum	tintinnabulum
two cents' worth	two pennies' worth
telecardiographic	electrocardiographic
third-class value	third-class object
tectocephalic	scaphocephalic
tetramic acid	pyrrolidinedione
textile banana	abaca
thalassoid	marine
Turkicize	Turkify}}
telegonic	telegonous
tread on eggshells	walk on eggshells
treehole	tree hollow
time spread	calendar spread
telecardiogram	electrocardiogram
triple energizer	triple warmer
ticket printer	ticket machine
turnip tops	turnip greens
triconsonantic	triconsonantal
target man	centre forward
trust someone as far as one can spit	trust someone as far as one could throw someone
tarsal gland	meibomian gland
tribologic	tribological
transgentleman	transman
taffeta glass	carnival glass
tuit	round tuit
trimethyl(vinyl)silane	vinyltrimethylsilane
the pock	smallpox
twenty-some	twentysomething}}
tourist guide	tour guide
toad-spit	cuckoo spit
table-tipping	table-turning
tear and wear	wear and tear
transrace	transracial
tantony	tantony pig
telemetrical	telemetric
transsystematic	transsystemic
tough pill to swallow	bitter pill to swallow
torsiometer	torsionmeter
time pencil	pencil detonator
taste of one's own poison	taste of one's own medicine
testworthy	testable
thatcher's rake	thatch-rake
true muonium	muononium
tail-pod radish	rat-tail radish
tripterine	celastrol
transisthmic	transisthmian
trouble ticket system	issue tracking system
tank wagon	tank car
thermochronometry	thermochronology
trephocyte	trophocyte
torque spanner	torque wrench
thioxanthenone	thioxanthone
torana	toran
tackboard	pinboard
theelol	estriol
titan primary	titan primary school
theoreticize	theoretize
thionitrobenzene	nitrothiophenol
thatching rake	thatch rake
trick play	trick mode
Trekkian	Star Trekkian
telebehavioral health	telemental health
truncheoner	truncheoneer
torsometer	torsionmeter
trimethylmethane	isobutane
theorism	theory
throw one's toys out of the cot	throw one's toys out of the pram
transluminant	transluminal
thiopyridine	mercaptopyridine
tail question	tag question
tryptan	tryptophan
timocratical	timocratic
trifluoromethane	methyl fluoride
time and materials	time and material
training bib	bib
teretiform	terete
traffic spikes	spike strip
torsimeter	torsionmeter
trust someone as far as one could spit	trust someone as far as one could throw someone
tourist court	motel
thiodipropionate	thiobispropanoate
tasseomancy	tasseography
trad pub	trad-pub
telefax	telefacsimile
tig ol' bitties	tig bitties
trumpet-player	trumpeter
tough act to follow	hard act to follow
thumbnut	wingnut
trainspottery	trainspotterish
th sound	dental fricative
telehealthcare	telehealth
thick client	fat client
trash bandit	trash panda
tongue punch	tonguefuck
tie down strap	tiedown
thinliness	thinness
turcopolier	turcopole}}
telephone answering machine	answering machine
Troxler's fading	Troxler effect
transcarboxylase	carboxyltransferase
Tipler time machine	Tipler cylinder
tachyonic antitelephone	antitelephone
throw one's rattle out of the pram	throw one's toys out of the pram
trade places	change places
travel agent	travel agency
triglyphical	triglyphic
trichloroethene	trichloroethylene
transinformation	mutual information
transprotein	transmembrane protein
tubies	tubulars
terrestrial branch	earthly branch
tatweel	kashida
tao	circuit
tropacaine	tropacocaine
trumpet marine	tromba marina
teguminal	tegumental
the floor is lava	hot lava
tenor horn	althorn
tree duck	wood duck}}
truth drug	truth serum
twincestual	twincestuous
throw one's rattle out of the cot	throw one's toys out of the pram
tribavirin	ribavirin
tertiary work	tertiary source
thrust diamond	shock diamond
Troxler fading	Troxler effect
tardbrain	idiot
transrepressional	transrepressive
trigonometrical station	triangulation pillar}}
tropical yam	name
thermoprotectant	thermoprotective
that tears it	that does it
take one's life	take one's own life
tail-beam	tail-pole
turning gear	jacking gear
turban snail	turban shell
take some air	get some air
triazo	azido
trusty dusty	trustworthy
thin-crust pizza	New York-style pizza}}
taco vampiro	vampire taco
the dumps	the pits
terricoline	terricolous
tinker's fart	tinker's damn
touch a chord	strike a chord
throughput	etendue
teratospermia	teratozoospermia
trisomy X	triple X syndrome
troglomorphy	troglomorphism
tenectomy	tenonectomy
teru-tero	southern lapwing
Tengrianism	Tengrism
transphosphorylase	phosphotransferase
thermoreception	thermoception
twirl one's thumbs	twiddle one's thumbs
thiazolidendione	glitazone
thalidomide child	thalidomide baby
table hockey	rod hockey}}
transplacentary	transplacental
transendothelium	transendothelial
triangular harp	frame harp
trioctanoin	tricaprylin
toxocarosis	toxocariasis
Texas League single	Texas leaguer
tentpole film	tentpole movie
Thracomania	Dacomania
tonitruant	tonitruous
temporoparietalis muscle	temporoparietalis
tuning peg	tuning key
thumbikin	thumbikins
tailcord	tailgut
tetraparalysis	tetraplegia
tried and tested	tried and true
theologus	theologian
throw in one's lot with	cast in one's lot with
talk through one's ass	talk out of one's ass
terpinolene	terpinene
Tibetanist	Tibetologist
the plague	the hell
temporomedial	temporomesial
thoroughbass	figured bass
tropyl	tropylium
tomax	tomahawk
trefanocide	trifluralin
tintometer	colorimeter
tradpub	trad-pub
textbook example	textbook case
them-and-us	us-and-them
trigonum	os trigonum
turn about	turn and turn about
typhinia	relapsing fever
transsuccinylase	succinyltransferase
tenuation	attenuation
transformylase	formyltransferase
turning-beam	tail-pole
turriculated	turriculate
throw for a loop	knock for a loop
teething trouble	teething troubles
tertiary healthcare	tertiary care
ten to the dozen	nineteen to the dozen
t-butyl	tertiary butyl}}
trypsination	trypsinization
ubiquitinized	ubiquitinated
unquenching	unquenchable
unpolitic	impolitic
ungrammatic	ungrammatical
unindex	deindex
university town	college town
underdrift	undertow
undecylaldehyde	undecanal
unipar	unipara
unbelievingly	incredibly
umbilectomy	omphalectomy
uplighter	uplight
unike	unicycle
undeclinable	indeclinable
urocystis	urocyst
unstaining	nonstaining
urban renew	urban renewal
urbaner	urbanite
urine bottle	pee bottle
undisirregardlessly	regardlessly
universal basic income	basic income
unempty	unemptied
ungrudged	unbegrudged
uteral	uterine
unsensitive	insensitive
unoffensively	inoffensively
ungainsome	unprofitable
uninitialization	deinitialization
ulcerative gingivitis	acute necrotizing ulcerative gingivitis
urved	urvant
uroneural	urodermal
unconsiderable	inconsiderable
underflavour	undertaste
underletting	subletting
urushinic acid	laccic acid
upper ten	upper ten thousand
Universalist Unitarian	Unitarian Universalist
unfractioned	unfractionated
unconceivably	inconceivably
unprotectible	unprotectable
unrued	unregretted
unviability	inviability
uninitialize	deinitialize
unicast	singlecast
unassembler	disassembler
unsensitiveness	insensitiveness
unboldened	unemboldened
uncorrectly	incorrectly
unbiological	nonbiological
uveomeningitis	Vogt-Koyanagi-Harada disease
under the loupe	under the microscope
unipotential	unipotent
unproportionally	disproportionately
unwhite	nonwhite
undubitably	indubitably
unholy trinity	impossible trinity
unwindase	helicase
Uganda grass	Napier grass
unikaryotic	monokaryotic
unquenchingly	unquenchably
unsensitivity	insensitivity
urushinic	laccic
undisirregardless	regardless
un-rock and roll	uncool
undocumented	undocumented immigrant
unsubstantiality	insubstantiality
ukuleleist	ukulelist
uninstallment	uninstallation
undoubtlessly	without a doubt
unmistaking	unmistakeable
uniski	monoski}}
unipersonal	impersonal
ultracain	articaine
umbrette	hammerkop
unsensitively	insensitively
under the magnifying glass	under the microscope
unattentively	inattentively
urban regeneration	urban renewal
unassembly	disassembly
unproportional	disproportionate
unscholastical	unscholastic
unemployment trap	welfare trap
unicortical	monocortical
Uralist	Uralicist
uroepithelium	urothelium
undelicate	indelicate
urticaria-deafness-amyloidosis syndrome	Muckle-Wells syndrome
unistratified	monostratified
undepended	independent
utility calculus	felicific calculus
urman	taiga
uberculture	overculture
uniexponential	monoexponential
umlaut	diaeresis
unireme	monoreme
unbearingly	unbearably
uncapitalist	non-capitalist
Venturer	Venturer Scout
Virchow's gland	Virchow's node
verification principle	verifiability principle
vblog	vlog
Vincent's angina	acute necrotizing ulcerative gingivitis
volcanologic	volcanological
viralness	virality
vidblogging	vlogging
varicosed	varicose
Venus's girdle	belt of Venus
virusemia	viraemia
vanilla essence	vanilla extract
vandalizer	vandal
velocitometry	velocimetry
verifiability criterion	verifiability principle
visiting researcher	visiting scholar
variative	variational
Vincent's infection	acute necrotizing ulcerative gingivitis
video girl	video vixen
vibrance	vibrancy
vitriolic acid	sulfuric acid
vasocontraction	vasoconstriction
visionphone	videophone
varsity jacket	letter jacket
vanadomolybdate	molybdovanadate
variosity	variety
vierbein	tetrad
vorticular	vortical
vaginal discharge	vaginal fluid
virgula	virga
visuotopic	retinotopic
vociferocity	vociferousness
Vietnamese cinnamon	Saigon cinnamon
vasotribe	angiotribe
virtuous cycle	virtuous circle
virazole	ribavirin
vasoprotecting	vasoprotective
validation suite	test suite
Vincent's stomatitis	acute necrotizing ulcerative gingivitis
virgil	slash
videograph	video
Vestal	Vestan}}
vibracularium	vibraculum
visual rhyme	eye rhyme
vividity	vividness
visuotopically	retinotopically
valleculate	vallecular
virotype	pathotype
vasospasmic	vasospastic
viola paradon	baryton
vorvolaka	vrykolakas
vasopressive	vasoactive
viticulturalist	viticulturist
viewphone	videophone
virtual function	virtual method
Vietnamese cassia	Vietnamese cinnamon
verrucate	verrucose
visitor design pattern	visitor pattern
vahine	wahine
veiled plate	fogged plate
vomeronasal organ	Jacobson's organ
vasostasis	venostasis
vrykolaka	vrykolakas
viceroyal	viceregal
valvated	valvate
vasorelaxing	vasorelaxant
Viennese horn	Vienna horn
velated	velate
vulva dentata	vagina dentata
vector verb	light verb
visiting lecturer	visiting scholar
visiting professor	visiting scholar
Vidian	pterygoid
vertical mower	verticutter
visuotopy	retinotopy
velutinate	velutinous
vicesimal	vigesimal
videoteleconference	video conference
videodermoscopical	videodermoscopic
vitamin B6	pyridoxine
vacuum flask	thermos
vanillylacetone	zingerone
volcanoclastic	pyroclastic
voice calling in the wilderness	voice in the wilderness
virtual machine monitor	hypervisor
verification criterion	verifiability principle
visiting fellow	visiting scholar
ventive	venitive
virgin oil	virgin olive oil
Valkyr	valkyrie
viola da gamba	viol
vinylpolysiloxane	polyvinylsiloxane
Valsalva	Valsalva device
veth	begar
Van Allen belt	Van Allen radiation belt
viola di bordone	baryton
voice crying in the wilderness	voice in the wilderness
vacuolarization	vacuolization
vidblog	vlog
virginial	virginal
vox caelestis	vox angelica
westly	westerly
worserererer	worse
waterbike	aquabike}}
watering pot	watering can
wild pig syndrome	wild man syndrome
war movie	war film
waist overalls	denim jeans}}
while one is about it	while one is at it
womanfriend	girlfriend
whalehead	shoebill
worstestest	worst
waisted drum	hourglass drum
writ of summons	summons}}
waboom	wagenboom
white birch	paper birch
waiverable	waivable
wagon tree	wagenboom
white fat	white adipose tissue}}
white line fever	highway hypnosis
well, well	well, well, well
warfront	battlefront
worsererer	worse
Winnipeg goldeye	goldeye
wikicode	wiki markup
wonderbread	white bread
werepuppy	werepup
white room	cleanroom
worldwidely	worldwide
windsucker	windfucker
work the angles	play the angles
wheel animalcule	wheel animal
wrench in the works	spanner in the works
white pee	semen
worserer	worse
wax end	waxed end
weaver's hitch	sheet bend
whip coral	sea whip coral
whatevers	whatever
weight	mass}}
wereman	werehuman
Worcester sauce	Worcestershire sauce
wild pig	wild boar}}
watchclock	watchman's detector
wowsers	wow
wheel fiddle	hurdy-gurdy
wet haze	damp haze
wastepaper bin	wastepaper basket
wowie	wow!
wear the breeches	wear the trousers
work history	employment history
wartyback	pimpleback
white wolf	spirit wolf}}
whitefin dolphin	baiji
Windsor bean	fava bean
walking school bus	walking bus
wingmate	wingman
white-fleshed sweet potato	white sweet potato
worsely	worse}}
white arsenic oxide	white arsenic
wormroot	wormgrass
Web scutter	Web spider
wood-thistle	tall thistle}}
wedding band	wedding ring
weather-gaw	sun dog
werebeast	wereanimal
Whedonspeak	Buffyspeak
womanslaughter	femicide
woodwinder	woodwindist
white coat high blood pressure	white coat hypertension
webstore	webshop
water bottle flipping	bottle flipping
whirlpool galaxy	spiral galaxy
Whedonian	Whedonite
wrapround	wraparound
walk tall	stand tall
whiteflaw	whitlow
whiteware	white goods
womansplain	femsplain
world's tiniest violin	world's smallest violin
wet rag	wet blanket}}
weaver's knot	sheet bend
wowzah	wow
Whipple	 Whipple procedure
water pepper	hydropiper
weighing scales	scales
Wulff net	stereonet
Web robot	Web spider
witchety	witchety grub
Web crawler	Web spider
wind cone	windsock
Wagnerianism	Wagnerism
white leg	phlegmasia alba dolens
white gravy	sawmill gravy
weaselish	weasely
wind dropsy	hoove
white coat effect	white coat hypertension
women's room	ladies' room
watchman's time detector	watchman's detector
washhand-stand	washstand
weightage	weighting
whalebone whale	baleen whale
walking corpse syndrome	Cotard's syndrome
wild rhubarb	burdock
Westfalish	Westphalian}}
witchetty	witchetty grub
white line disease	seedy toe
Winstonian	Churchillian
wash one's dirty linen in public	air one's dirty laundry in public
worldy	worldly
white coat syndrome	white coat hypertension}}
willful blindness	willful ignorance
woods oyster	oyster mushroom
witgat	motlopi
wifi syndrome	electromagnetic hypersensitivity}}
webbed foot	webfoot
werewolfery	werewolfism
white radish	daikon
Wernicke's disease	Wernicke's encephalopathy
Wiener-Kolmogorov prediction	kriging
whateverism	ism
water pimpernel	brookweed
waist-deep in the Big Muddy	knee-deep in the Big Muddy
Yankee cheese	American cheese
yellow phosphorus	white phosphorus
yachtmanship	yachtsmanship
yellow terror	yellow peril
yellow woodland anemone	yellow wood anemone
yuanyang hudie	yuanyang hudie pai
yellow cobra	Cape cobra
yardland	virgate
yellow dog fund	slush fund
yumpie	yuppie
youch	ouch
yikers	yikes
Young dewberry	youngberry
yperite	mustard gas
Y-moth	silver Y
yarri	Queensland tiger}}
Yahwism	Jehovism
yieldful	yielding
yowch	ouch
Yankee football	American football
yurta	yurt
yesterevening	yestereve
yellow menace	yellow peril
yampi	name
yestereven	yestereve
Zöllner's lines	Zöllner illusion
zero client	thin client
zizzle	sizzle
zebra mule	zebrule
zheng	guzheng
zoonotic	zoonosis
zooks	gadzooks
zeomycin	zeocin
Zipser German	Zipser
zebra cichlid	convict cichlid
zoanthinarian	zoanthid
zero derivation	anthimeria
zoolatria	zoolatry
zebra cake	icebox cake
zappozap	kasuyu
Zaidite	Zaidi
zebub	zimb
zowerswopped	bad-tempered
zhuizixian	zhuihu
zeroadic	niladic
zocco	socle
zebra lionfish	zebra turkeyfish
zygodactylism	zygodactyly
zhuiqin	zhuihu
zymoscope	zymometer
zenith sector	zenith telescope
zoonomia	zoonomy
zinc-carbon battery	dry cell battery
Zolaistic	Zolaesque
zilipendwa	zilizopendwa
zouhun	tiesese
zero dark thirty	oh dark thirty
zoolith	zoolite
zydeco rub-board	rubboard
zama	zama-zama
Zunian	Zuni
zombie deer disease	chronic wasting disease
zip tie	cable tie
zonated	zonate
